date,open,high,low,close,volume,Name,SMA,WMA,Momentum,RSI,WilliamK,MACD,CCI,acc_dist,AD-:21,Arronup,AroonDown,AroonOscillator,ATR,Pivot_Point,Resistance_1,Resistance_2,Resistance_3,Support_1,Support_2,Support_3,SO%k,On_Balance_Volume,Price_Volume_Trend,y
8/9/2013,65.5199,65.7799,64.8071,64.9214,66772986,AAPL,65.54273,1.063357364,-0.9515,189.2636816,-32.79409248,2.601884562,37.85456978,-51081883.41,441514.4079,88,8,80,1.0514,65.16946667,65.53183333,66.14226667,66.50463333,64.55903333,64.19666667,63.58623333,0.117495888,-564942322,154722531.3,-1
8/15/2013,70.9171,71.7712,69.869,71.1299,122441893,AAPL,67.58592,1.062371816,-5.0528,128.7761025,-9.068698621,3.156409773,111.4742201,39882765.69,10153602.48,96,32,64,1.9022,70.92336667,71.97773333,72.82556667,73.87993333,70.07553333,69.02116667,68.17333333,0.662864052,-188137971,171040718.3,-1
8/19/2013,72.0485,73.3914,71.9999,72.5342,127478547,AAPL,68.70135,1.063450039,-6.07,130.0978866,-9.301518062,3.507419354,108.0666988,-29581618.99,10659959.09,88,24,64,1.63,72.64183333,73.28376667,74.03333333,74.67526667,71.89226667,71.25033333,70.50076667,0.383974129,29802465,173216669.2,1
8/20/2013,72.8156,72.9385,71.5456,71.5814,89531771,AAPL,69.21307,1.06313216,-5.1558,145.8575487,-19.70132358,3.564589347,83.21409982,-84929520.44,6306440.213,96,20,76,1.3929,72.02183333,72.49806667,73.41473333,73.89096667,71.10516667,70.62893333,69.71226667,0.025701773,-59729306,172040591.2,-1
8/21/2013,71.9414,72.4499,71.5999,71.7656,83809726,AAPL,69.74707,1.063106116,-5.9071,148.7251387,-18.81712963,3.535048767,72.14449717,-51133792.83,3690621.043,92,16,76,0.8685,71.93846667,72.27703333,72.78846667,73.12703333,71.42703333,71.08846667,70.57703333,0.194941176,24080420,172256258.3,1
8/22/2013,72.1399,72.2271,71.1714,71.8514,60877852,AAPL,70.34636,1.063975532,-6.93,155.0698786,-17.93972718,3.611316191,60.79241936,17547722.24,4321617.428,88,12,76,1.0557,71.74996667,72.32853333,72.80566667,73.38423333,71.27283333,70.69426667,70.21713333,0.644122383,84958272,172329041.4,1
8/23/2013,71.8956,71.9071,71.3356,71.5742,55587686,AAPL,71.01164,1.065683865,-4.8086,176.654102,-21.16887807,3.72649581,51.59212146,-9172211.356,3707213.021,84,8,76,0.5715,71.60563333,71.87566667,72.17713333,72.44716667,71.30416667,71.03413333,70.73266667,0.417497813,29370586,172114586.2,-1
8/26/2013,71.5356,72.8856,71.4999,71.8528,82398085,AAPL,71.52036,1.065092729,-1.9143,153.0211929,-17.92341833,3.899712281,53.24690672,-40428994.73,1697748.254,80,4,76,1.3857,72.07943333,72.65896667,73.46513333,74.04466667,71.27326667,70.69373333,69.88756667,0.254672729,111768671,172435317.8,1
8/27/2013,71.1428,71.7871,69.4714,69.7985,105930335,AAPL,71.50636,1.056822127,1.4157,244.4691512,-41.85431544,4.207405696,22.46332331,-76004340.63,-1839665.543,76,0,76,2.3814,70.35233333,71.23326667,72.66803333,73.54896667,68.91756667,68.03663333,66.60186667,0.141253185,5838336,169406727.5,-1
8/28/2013,69.4285,70.8285,69.4285,70.1279,76793066,AAPL,71.39773,1.047381015,1.002,200.8502366,-38.01707769,4.244928903,15.2653579,-65822.628,-1758916.462,72,8,64,1.4,70.1283,70.8281,71.5283,72.2281,69.4281,68.7283,68.0281,0.499571429,82631402,169769137,1
8/29/2013,70.2356,70.9285,70.1614,70.2428,59807748,AAPL,71.30902,1.038381258,1.5186,163.3028902,-36.67858765,4.05556845,16.47345207,-47114876.96,-3823476.193,68,4,64,0.8006,70.44423333,70.72706667,71.21133333,71.49416667,69.95996667,69.67713333,69.19286667,0.106113936,142439150,169867128.1,1
8/30/2013,70.2856,70.4214,69.4999,69.6022,68078395,AAPL,71.0931,1.027689143,2.932,241.3382218,-46.44424288,3.648636081,3.280881238,-52962996.61,-6060115.686,64,0,64,0.9215,69.84116667,70.18243333,70.76266667,71.10393333,69.26093333,68.91966667,68.33943333,0.11101465,74360755,169246267,-1
9/3/2013,70.4428,71.5142,69.6214,69.7971,83000148,AAPL,70.81939,1.016397552,1.7843,-2735.360679,-55.06649099,3.261418895,8.499512698,-67591096.86,-8860593.797,60,0,60,1.912,70.3109,71.0004,72.2037,72.8932,69.1076,68.4181,67.2148,0.092825444,157360903,169478683.9,1
9/4/2013,71.3656,71.7485,70.8971,71.2415,86049453,AAPL,70.7854,1.008724436,0.5241,14785.71429,-54.25067501,2.864135589,23.47404391,-16433686.94,-9205250.019,56,0,56,1.9514,71.2957,71.6943,72.1471,72.5457,70.8429,70.4443,69.9915,0.404510218,243410356,171259414.5,1
9/5/2013,71.4642,71.5256,70.5199,70.7528,58913211,AAPL,70.68412,1.000198471,1.0986,-1070.405728,-66.58255318,2.373380101,13.78250691,-31626968.9,-10225619.29,52,0,52,1.0057,70.93276667,71.34563333,71.93846667,72.35133333,70.33993333,69.92706667,69.33423333,0.231579994,184497145,170855283.7,-1
9/6/2013,71.2056,71.3399,69.9928,71.1742,89551595,AAPL,70.6164,0.992297006,0.4,-651.6348774,-55.94892629,1.991494733,7.305822149,67521011.83,-6687709.12,48,0,48,1.3471,70.83563333,71.67846667,72.18273333,73.02556667,70.33136667,69.48853333,68.98426667,0.876995026,274048740,171388648.3,1
9/9/2013,72.1428,72.5599,71.9256,72.3099,84887432,AAPL,70.68997,0.986518184,-0.4571,-1867.721801,-27.29062051,1.630376239,38.64706191,17973170.61,-5565557.351,44,20,24,1.3857,72.26513333,72.60466667,72.89943333,73.23896667,71.97036667,71.63083333,71.33606667,0.605864733,358936172,172743165.2,1
9/10/2013,72.3142,72.4928,69.9285,70.6628,185494435,AAPL,70.57097,0.978085509,-0.8643,-456.0526889,-64.83475783,1.249747675,-3.065873718,-79259935.43,-8918732.291,40,16,24,2.5643,71.02803333,72.12756667,73.59233333,74.69186667,69.56326667,68.46373333,66.99896667,0.286354951,173441737,168517908.6,-1
9/11/2013,66.7157,67.6699,66.4014,66.8156,224250866,AAPL,70.27268,0.967039789,3.3123,-80.91111111,-93.61216495,0.848193156,-162.6023559,-77802763.99,-12052885.31,36,12,24,4.2614,66.9623,67.5232,68.2308,68.7917,66.2547,65.6938,64.9862,0.326527395,-50809129,156308684.9,-1
9/12/2013,66.9285,67.9142,66.5728,67.5271,100874816,AAPL,70.0126,0.956745449,2.7157,-107.0878524,-82.6393387,0.354096985,-143.272427,42654089.49,-9563884.477,32,8,24,1.3414,67.33803333,68.10326667,68.67943333,69.44466667,66.76186667,65.99663333,65.42046667,0.711420904,50065687,157382871.7,1
9/13/2013,67.0485,67.4041,66.3856,66.4142,74578903,AAPL,69.62974,0.94490962,3.188,-89.74418605,-99.56,0.084420553,-163.1916642,-70390475.65,-12331191.86,28,4,24,1.1415,66.73463333,67.08366667,67.75313333,68.10216667,66.06516667,65.71613333,65.04666667,0.028080511,-24513216,156153752.4,-1
9/16/2013,65.8571,65.9442,63.8885,64.3028,136823442,AAPL,69.0998,0.931168329,5.4943,-57.64503311,-95.39518289,-0.341112861,-228.9969859,-81673418.14,-15485790.59,24,0,24,2.5257,64.71183333,65.53516667,66.76753333,67.59086667,63.47946667,62.65613333,61.42376667,0.201537189,-161336658,151803944.4,-1
9/17/2013,63.9942,65.6728,63.9285,65.0456,99756489,AAPL,68.62465,0.918435704,6.1959,-107.1977109,-86.65613396,-0.85654731,-188.5013954,28017373.14,-13506769.58,20,96,-76,1.7443,64.8823,65.8361,66.6266,67.5804,64.0918,63.138,62.3475,0.640428825,-61580169,152956291.1,1
9/18/2013,66.1685,66.6214,65.8085,66.3828,113743049,AAPL,68.13878,0.905898341,4.37,-162.9542602,-71.23532532,-1.166854599,-109.4940758,46972003.38,-10755605.35,16,92,-76,1.5758,66.2709,66.7333,67.0838,67.5462,65.9204,65.458,65.1075,0.706482962,52162880,155294607.7,1
9/19/2013,67.2428,67.9756,67.0356,67.4714,100918377,AAPL,67.81064,0.895672964,3.7028,-255.3402612,-58.68141246,-1.299038146,-56.98094277,-7343422.326,-10600391.46,12,88,-76,1.5928,67.4942,67.9528,68.4342,68.8928,67.0128,66.5542,66.0728,0.463617021,153081257,156949550.6,1
9/20/2013,68.2856,68.3642,66.5714,66.7728,174570949,AAPL,67.3705,0.884131554,5.5371,-250.1060295,-66.73778167,-1.590396821,-56.37136849,-135348962,-16274782.24,8,84,-76,1.7928,67.23613333,67.90086667,69.02893333,69.69366667,66.10806667,65.44333333,64.31526667,0.112338242,-21489692,155142040.1,-1
9/23/2013,70.8714,70.9871,68.9428,70.0914,190021706,AAPL,67.14865,0.875805296,0.5714,3465.91913,-28.46714487,-1.766446874,26.70669628,23507552.44,-14465276.36,4,80,-76,4.2143,70.0071,71.0714,72.0514,73.1157,69.0271,67.9628,66.9828,0.561854914,168532014,164586095.7,1
9/24/2013,70.6971,70.7814,69.6885,69.8714,90602953,AAPL,67.06951,0.869365936,-3.0558,-639.0628421,-31.00422077,-1.988840764,32.02782054,-60277616.55,-16548994.22,0,76,-76,1.0929,70.11376667,70.53903333,71.20666667,71.63193333,69.44613333,69.02086667,68.35323333,0.167352914,77929061,164301714.9,-1
9/25/2013,69.8856,69.9485,68.7757,68.7899,79110192,AAPL,67.26694,0.866356764,-1.2628,-446.0644964,-43.47625528,-2.380257603,7.541666209,-77194494.99,-19307299.51,0,72,-72,1.1728,69.17136667,69.56703333,70.34416667,70.73983333,68.39423333,67.99856667,67.22143333,0.012107776,-1181131,163077212.8,-1
9/26/2013,69.4285,69.7942,69.1285,69.4599,59086559,AAPL,67.46022,0.863373211,-3.0457,-525.2522896,-35.74970593,-2.625874856,16.71117379,-257399.7613,-18440887.78,12,68,-56,1.0043,69.46086667,69.79323333,70.12656667,70.45893333,69.12753333,68.79516667,68.46183333,0.497821842,57905428,163652704.2,1
9/27/2013,69.1114,69.2385,68.6742,68.9642,56816676,AAPL,67.71522,0.86112754,-4.6614,-235.1884508,-41.46619923,-2.351196169,4.64025554,1580758.131,-17530304.13,8,64,-56,0.7857,68.95896667,69.24373333,69.52326667,69.80803333,68.67943333,68.39466667,68.11513333,0.51391104,1088752,163247232.5,-1
9/30/2013,68.1785,68.8085,67.7729,68.1071,64852879,AAPL,68.09565,0.860350032,-3.0615,-307.8882498,-50.97102611,-2.177048088,-13.96300937,-22995342.96,-17778847.56,4,60,-56,1.1913,68.2295,68.6861,69.2651,69.7217,67.6505,67.1939,66.6149,0.322711472,-63764127,162441228.7,-1
10/1/2013,68.3499,69.8771,68.3401,69.7085,88255013,AAPL,68.56194,0.860721064,-3.3257,327.3566318,-18.01200237,-1.812620398,18.49076875,68892885.23,-13837216.45,0,56,-56,1.77,69.30856667,70.27703333,70.84556667,71.81403333,68.74003333,67.77156667,67.20303333,0.890305791,24490886,164516365.9,1
10/2/2013,69.3756,70.2571,69.1071,69.9371,71849680,AAPL,68.91737,0.859734813,-2.4657,372.9128631,-14.79164906,-1.094585685,37.71878759,31863771.13,-11758888.74,32,52,-20,1.15,69.7671,70.4271,70.9171,71.5771,69.2771,68.6171,68.1271,0.72173913,96340566,164751987.7,1
10/3/2013,70.0728,70.3356,68.6769,69.0585,80629248,AAPL,69.07608,0.856311204,-2.2857,339.8706652,-27.1687375,-0.575144885,29.45651615,-43530169.16,-13203708.13,28,48,-20,1.6587,69.357,70.0371,71.0157,71.6958,68.3784,67.6983,66.7197,0.230059685,15711318,163739065.2,-1
10/4/2013,69.1228,69.2285,68.3714,69.0042,64673329,AAPL,69.29922,0.853681034,1.0872,191.16008,-27.93367706,-0.180976107,17.93782823,30823771.9,-11201572.43,24,44,-20,0.8571,68.86803333,69.36466667,69.72513333,70.22176667,68.50756667,68.01093333,67.65046667,0.738303582,-48962011,163688213.3,-1
10/7/2013,69.5085,70.3785,69.3356,69.6785,77919884,AAPL,69.25793,0.847990316,0.1929,192.5079324,-18.53908707,0.115607322,74.96755952,-26680593.13,-11905461.82,20,40,-20,1.3743,69.79753333,70.25946667,70.84043333,71.30236667,69.21656667,68.75463333,68.17366667,0.328794707,28957873,164449636.2,1
10/8/2013,69.9914,70.0914,68.6485,68.7056,72418815,AAPL,69.14135,0.841413676,0.0843,326.3948683,-44.05630865,0.47147628,58.20862936,-66687143.59,-14396543.38,16,36,-20,1.4429,69.1485,69.6485,70.5914,71.0914,68.2056,67.7056,66.7627,0.039573082,-43460942,163438474,-1
10/9/2013,69.2342,69.6842,68.3256,69.5125,75311488,AAPL,69.21361,0.8371923,-0.0526,357.640488,-33.39447879,0.416157686,62.66110983,56275741.66,-11182929.07,12,32,-20,1.3586,69.1741,70.0226,70.5327,71.3812,68.664,67.8155,67.3054,0.873619903,31850546,164322955.6,1
10/10/2013,70.1885,70.3399,69.5771,69.9482,69650490,AAPL,69.26244,0.832775873,-0.984,243.6071046,-23.52741355,0.487115324,118.4257166,-1880964.99,-10759957.02,8,28,-20,0.8274,69.95506667,70.33303333,70.71786667,71.09583333,69.57023333,69.19226667,68.80743333,0.486497116,101501036,164759520.5,1
10/11/2013,69.5699,70.5485,69.3085,70.4016,66934938,AAPL,69.40618,0.829537756,-2.2945,1570.05158,-18.21604132,0.693738224,119.3573121,51075676.08,-7948259.718,4,24,-20,1.24,70.0862,70.8639,71.3262,72.1039,69.6239,68.8462,68.3839,0.881532258,168435974,165193388.7,1
10/14/2013,69.9756,71.0828,69.9071,70.8628,65474542,AAPL,69.68175,0.827875113,-1.1543,537.7748638,-6.646726487,0.85752482,132.2108773,40971013.48,-5723911.28,0,20,-20,1.1757,70.61756667,71.32803333,71.79326667,72.50373333,70.15233333,69.44186667,68.97663333,0.812877435,233910516,165622311.6,1
10/15/2013,71.0721,71.7142,70.7885,71.2399,80018603,AAPL,69.83489,0.824840684,-1.3028,233.0040816,-12.03410042,1.183277783,149.1716576,-1979503.088,-5553656.469,0,16,-16,0.9257,71.24753333,71.70656667,72.17323333,72.63226667,70.78086667,70.32183333,69.85516667,0.487630982,313929119,166048134.7,1
10/16/2013,71.5414,71.7899,71.3185,71.5876,62775013,AAPL,69.99994,0.821990142,-2.5291,253.1512901,-5.036096589,1.558101859,134.441333,8895568.24,-4896673.004,96,12,84,0.55,71.56533333,71.81216667,72.03673333,72.28356667,71.34076667,71.09393333,70.86936667,0.570852779,376704132,166354520.2,1
10/17/2013,71.4256,72.1114,71.3828,72.0714,63398335,AAPL,70.30123,0.82073295,-3.0672,188.9192842,-0.921977642,1.504660178,126.0756177,56437222.18,-2107956.199,96,8,88,0.7286,71.8552,72.3276,72.5838,73.0562,71.599,71.1266,70.8704,0.945100192,440102467,166782975.9,1
10/18/2013,72.2842,72.7514,72.2442,72.6985,72635570,AAPL,70.67066,0.820277466,-3.02,141.5080368,-1.062569047,1.484000636,135.1060282,57484065.06,601525.5524,96,4,92,0.68,72.5647,72.8852,73.0719,73.3924,72.378,72.0575,71.8708,0.895701893,512738037,167414984.8,1
10/21/2013,73.1099,74.8999,73.0742,74.4802,99526945,AAPL,71.15083,0.821158333,-5.7746,139.9396442,-6.383949622,1.571284656,184.9301773,53767555.38,3018804.965,96,0,96,2.2014,74.15143333,75.22866667,75.97713333,77.05436667,73.40296667,72.32573333,71.57726667,0.770115572,612264982,169854198.2,1
10/22/2013,75.2006,75.4927,72.5756,74.2667,133515753,AAPL,71.70694,0.822825862,-4.7542,148.9490946,-17.10594243,1.550412105,149.0608041,21287640.71,3849417.063,96,0,96,2.9171,74.11166667,75.64773333,77.02876667,78.56483333,72.73063333,71.19456667,69.81353333,0.579719585,478749229,169471470.8,-1
10/23/2013,74.1428,75.0956,74.1428,74.9942,78431122,AAPL,72.25511,0.824397876,-5.046,120.9023367,-6.955393395,1.51871983,147.0858452,61737344.14,6481323.072,96,0,96,0.9528,74.7442,75.3456,75.697,76.2984,74.3928,73.7914,73.44,0.893576826,557180351,170239764.5,1
10/24/2013,74.9999,76.0671,74.6356,75.9871,96191095,AAPL,72.859,0.826592738,-5.5855,116.9900758,-1.033391462,1.754846063,147.1655082,85439732.65,10071170.52,92,4,88,1.4315,75.56326667,76.49093333,76.99476667,77.92243333,75.05943333,74.13176667,73.62793333,0.944114565,653371446,171513304.9,1
10/25/2013,75.9021,76.1756,75.0156,75.1368,84448133,AAPL,73.33252,0.827245376,-4.274,137.3138157,-13.23312102,1.963407893,116.4372118,-66801385.21,6576193.193,96,0,96,1.16,75.44266667,75.86973333,76.60266667,77.02973333,74.70973333,74.28266667,73.54973333,0.104482759,568923313,170568325.4,-1
10/28/2013,75.5771,75.8571,74.7442,75.6965,137610123,AAPL,73.81589,0.82800346,-4.4566,115.2169249,-6.103184713,2.114588341,98.27918298,97893732.03,10727863.8,96,20,76,1.1129,75.4326,76.121,76.5455,77.2339,75.0081,74.3197,73.8952,0.855692335,706533436,171593394.2,1
10/29/2013,76.6099,77.0356,73.5056,73.8111,158952115,AAPL,74.07301,0.826160272,-2.2235,168.6083841,-37.0206659,2.394489806,68.96366098,-131439440.1,4264415.711,92,16,76,3.53,74.7841,76.0626,78.3141,79.5926,72.5326,71.2541,69.0026,0.086543909,547581321,167634316.6,-1
10/30/2013,74.2299,75.3599,73.8599,74.9851,88540697,AAPL,74.41276,0.825283412,-2.9137,158.5518871,-26.53647552,2.656985893,58.7956901,44293959.35,6084289.255,96,12,84,1.5488,74.73496667,75.61003333,76.23496667,77.11003333,74.11003333,73.23496667,72.61003333,0.750133333,636122018,169042597.7,1
10/31/2013,74.9999,75.3556,74.4671,74.6716,68923785,AAPL,74.67278,0.82352458,-1.9731,176.4098361,-30.59362503,2.822081562,53.37422515,-37196347.67,4116627.559,92,8,84,0.8885,74.83143333,75.19576667,75.71993333,76.08426667,74.30726667,73.94293333,73.41876667,0.230163196,567198233,168754439,-1
11/1/2013,74.8599,74.9714,73.6914,74.2899,68722304,AAPL,74.83192,0.820674272,0.1903,206.3406379,-38.51721961,2.99717401,35.10610856,-4456211.9,3726884.969,88,4,84,1.28,74.31756667,74.94373333,75.59756667,76.22373333,73.66373333,73.03756667,72.38373333,0.467578125,498475929,168403150.1,-1
11/4/2013,74.4428,75.2599,74.1156,75.2499,61157033,AAPL,74.90889,0.817034572,-0.9832,190.882793,-28.58446319,3.122498591,41.83116053,60088134.41,6289187.11,84,0,84,1.1443,74.87513333,75.63466667,76.01943333,76.77896667,74.49036667,73.73083333,73.34606667,0.991261033,559632962,169193442.6,1
11/5/2013,74.9399,75.5549,74.7142,75.0641,66368071,AAPL,74.98863,0.813448038,-0.0699,210.1740256,-34.4842665,3.123625276,40.58565156,-11123184.49,5497589.703,80,24,56,0.8407,75.11106667,75.50793333,75.95176667,76.34863333,74.66723333,74.27036667,73.82653333,0.416200785,493264891,169029572.8,-1
11/6/2013,74.8785,74.9799,74.0285,74.4171,55844152,AAPL,74.93092,0.80841914,1.57,290.8683975,-46.32217662,2.969773729,20.9652931,-10224985.58,4782818.616,76,20,56,1.0356,74.47516667,74.92183333,75.42656667,75.87323333,73.97043333,73.52376667,73.01903333,0.408450704,437420739,168548235.3,-1
11/7/2013,74.2256,74.7414,73.1971,73.2131,65655100,AAPL,74.65352,0.801090416,1.9237,1204.003109,-79.77835288,2.825452638,0.130365898,-64294636.88,1642478.938,72,16,56,1.5443,73.7172,74.2373,75.2615,75.7816,72.693,72.1729,71.1487,0.010360681,371765639,167485996.4,-1
11/8/2013,73.5114,74.4471,73.2271,74.3656,69829543,AAPL,74.5764,0.795996753,1.3309,-4857.417103,-59.86547085,2.545865959,2.552051084,60499858.16,4318184.69,68,12,56,1.234,74.01326667,74.79943333,75.23326667,76.01943333,73.57943333,72.79326667,72.35943333,0.933196721,441595182,168585233.4,1
11/11/2013,74.2842,74.5242,73.4871,74.1496,56863303,AAPL,74.42171,0.790149851,-0.3385,-4753.714774,-64.70852018,2.101547257,-0.698733512,15785309.94,4839486.527,64,8,56,1.0371,74.05363333,74.62016667,75.09073333,75.65726667,73.58306667,73.01653333,72.54596667,0.638800501,384731879,168420070,-1
11/12/2013,73.9528,74.8456,73.8571,74.2871,51114651,AAPL,74.46931,0.78645502,0.698,-703.804271,-71.60349095,1.796547299,2.898601875,-6644646.083,4317414.661,60,4,56,0.9885,74.32993333,74.80276667,75.31843333,75.79126667,73.81426667,73.34143333,72.82576667,0.435002529,435846530,168514854.9,1
11/13/2013,73.9999,74.6071,73.8514,74.3762,49304927,AAPL,74.40842,0.781694893,0.2954,-252.8276119,-69.28227172,1.335246422,-3.15297628,19175225.68,4992851.014,56,0,56,0.7557,74.27823333,74.70506667,75.03393333,75.46076667,73.94936667,73.52253333,73.19366667,0.694455472,485151457,168573991.3,1
11/14/2013,74.6871,75.6114,74.5528,75.4514,70605087,AAPL,74.4864,0.778456184,-1.1615,1636.363636,-41.27132995,1.19492295,27.77274041,49262154.98,7005323.347,52,4,48,1.2352,75.2052,75.8576,76.2638,76.9162,74.799,74.1466,73.7404,0.848856981,555756544,169594675.2,1
11/15/2013,75.2256,75.5842,74.9271,74.9986,79479764,AAPL,74.55727,0.775150235,0.2513,-657.4437599,-53.06760453,0.903978182,24.7482736,-62183148.19,3860047.842,48,0,48,0.6571,75.16996667,75.41283333,75.82706667,76.06993333,74.75573333,74.51286667,74.09863333,0.108811444,476276780,169117700.1,-1
11/18/2013,74.9985,75.3128,74.0285,74.0898,61236224,AAPL,74.44126,0.769948188,0.9743,1646.32221,-76.7435196,0.649163142,-12.29130955,-55390579.63,1166555.502,44,0,44,1.2843,74.47703333,74.92556667,75.76133333,76.20986667,73.64126667,73.19273333,72.35696667,0.047730281,415040556,168375666.5,-1
11/19/2013,74.1471,74.7685,73.9956,74.2214,52234707,AAPL,74.35699,0.765130112,0.1957,-464.3053555,-57.57362382,0.468957099,-26.24846565,-21714337.38,126410.9673,40,0,40,0.7729,74.3285,74.6614,75.1014,75.4343,73.8885,73.5556,73.1156,0.292146461,467275263,168468447,1
11/20/2013,74.1756,74.3456,73.4756,73.5714,48545798,AAPL,74.27242,0.760328526,-0.3583,-322.2959462,-84.49654144,0.151740469,-73.42912836,-37854562.49,-1600161.624,36,0,36,0.87,73.79753333,74.11946667,74.66753333,74.98946667,73.24946667,72.92753333,72.37946667,0.110114943,418729465,168043303.2,-1
11/21/2013,73.9428,74.4585,73.3814,74.4479,65506861,AAPL,74.3959,0.757685452,-0.0823,2798.987342,-48.19202253,-0.115397722,-48.2026473,64217523.47,1391823.782,32,0,32,1.0771,74.09593333,74.81046667,75.17303333,75.88756667,73.73336667,73.01883333,72.65626667,0.99015876,484236326,168823725.5,1
11/22/2013,74.2171,74.5942,74.0756,74.2571,55931232,AAPL,74.38505,0.75373019,-0.1075,-348.7510073,-56.09493435,-0.280333987,-23.91357438,-16781526.61,565690.5935,28,0,28,0.5186,74.30896667,74.54233333,74.82756667,75.06093333,74.02373333,73.79036667,73.50513333,0.349980717,428305094,168680381.3,-1
11/25/2013,74.4314,75.1242,74.4285,74.8199,57348403,AAPL,74.45208,0.750607494,-0.5328,-1648.321048,-32.78382968,-0.226521713,44.58571742,7179884.866,866360.734,24,4,20,0.8671,74.79086667,75.15323333,75.48656667,75.84893333,74.45753333,74.09516667,73.76183333,0.562598821,485653497,169115029,1
11/26/2013,74.8742,76.5914,74.8571,76.1999,100345728,AAPL,74.64336,0.748794342,-1.8237,303.1859996,-11.53404237,-0.178013434,257.8956464,55041740.79,3329073.05,20,0,20,1.7715,75.8828,76.9085,77.6171,78.6428,75.1742,74.1485,73.4399,0.774260509,585999225,170965834.8,1
11/27/2013,76.6156,77.9999,76.1999,77.9942,90861841,AAPL,75.00516,0.748734251,-2.5428,150.5825019,-0.11868077,-0.058604612,484.2910696,90286382.67,7281976.864,16,44,-28,1.8,77.398,78.5961,79.198,80.3961,76.7961,75.598,74.9961,0.996833333,676861066,173105383.6,1
11/29/2013,78.4971,79.7613,78.2585,79.4385,79532215,AAPL,75.40387,0.749084248,-4.4399,147.6729287,-4.940160999,0.141159191,499.2383846,45365327.85,9013163.198,96,40,56,1.7671,79.15276667,80.04703333,80.65556667,81.54983333,78.54423333,77.64996667,77.04143333,0.785200958,756393281,174578164.6,1
12/2/2013,79.7142,80.6185,78.6885,78.7471,118135885,AAPL,75.77872,0.749146889,-4.6573,162.9429038,-25.85842395,0.396931017,324.0012172,-110962037.5,3559369.32,96,36,60,1.93,79.35136667,80.01423333,81.28136667,81.94423333,78.08423333,77.42136667,76.15423333,0.030362694,638257396,173549958.5,-1
12/3/2013,79.7571,80.9113,79.6685,80.9031,112741734,AAPL,76.46005,0.752226865,-6.6817,143.7394196,-0.108899189,0.525879867,290.205409,111253993.1,8454901.374,96,32,64,2.1642,80.4943,81.3201,81.7371,82.5629,80.0773,79.2515,78.8345,0.993401995,750999130,176636690.3,1
12/4/2013,80.7856,81.3128,80.1171,80.7142,94452666,AAPL,77.10933,0.754929059,-7.1428,148.6383717,-7.547217389,0.76891659,219.7526046,-118490.4232,8065177.287,96,28,68,1.1957,80.7147,81.3123,81.9104,82.508,80.1166,79.519,78.9209,0.499372752,656546464,176416153.5,-1
12/5/2013,81.8071,82.1622,80.9156,81.1286,111895315,AAPL,77.86505,0.758602101,-6.6807,154.2996548,-11.77113703,1.061606536,190.6357883,-73657384.48,4350292.833,96,24,72,1.448,81.40213333,81.88866667,82.64873333,83.13526667,80.64206667,80.15553333,79.39546667,0.170864752,768441779,176990642.5,1
12/6/2013,80.8271,80.9642,79.9385,80.0028,86088352,AAPL,78.42054,0.760262428,-5.7457,175.0509572,-24.59229227,1.420068872,118.5450339,-75294784.61,729855.0023,96,20,76,1.1901,80.30183333,80.66516667,81.32753333,81.69086667,79.63946667,79.27613333,78.61376667,0.062688895,682353427,175796017.4,-1
12/9/2013,80.1285,81.3685,80.1285,80.9185,80123533,AAPL,79.08668,0.762962711,-6.0986,141.6902192,-14.16385751,1.916494375,111.1791504,21969355.82,1695339.56,92,16,76,1.3657,80.80516667,81.48183333,82.04516667,82.72183333,80.24183333,79.56516667,79.00183333,0.637096774,762476960,176713099.3,1
12/10/2013,80.5113,81.1256,80.1713,80.7928,69567610,AAPL,79.68397,0.764957697,-4.5929,145.2354141,-15.59538994,2.316515583,89.11366731,21045969.83,2574959.496,88,12,76,0.9543,80.69656667,81.22183333,81.65086667,82.17613333,80.26753333,79.74226667,79.31323333,0.651262706,692909350,176605031.9,-1
12/11/2013,80.9999,81.5671,79.9556,80.1942,89929693,AAPL,80.0834,0.765039464,-2.2,144.1082322,-22.41253644,2.837923102,72.24583507,-63299566.1,-419486.0563,84,8,76,1.6115,80.5723,81.189,82.1838,82.8005,79.5775,78.9608,77.966,0.148060813,602979657,175938736,-1
12/12/2013,80.3058,80.7628,80.0042,80.0771,65572318,AAPL,80.29169,0.763328403,-0.6386,153.9739217,-23.74612792,3.320806439,55.77185212,-52969570.88,-2808239.684,80,4,76,0.7586,80.28136667,80.55853333,81.03996667,81.31713333,79.79993333,79.52276667,79.04133333,0.096098075,537407339,175842986.9,-1
12/13/2013,80.4071,80.4113,79.0956,79.2042,83205283,AAPL,80.26826,0.759450321,-0.4571,175.2036547,-36.57903198,3.596546982,34.31411125,-69469486.49,-5838433.68,76,0,76,1.3157,79.57036667,80.04513333,80.88606667,81.36083333,78.72943333,78.25466667,77.41373333,0.082541613,454202056,174935987.4,-1
12/16/2013,79.2885,80.3769,79.2871,79.6428,70648452,AAPL,80.35783,0.75666622,1.2603,177.1403098,-32.57690368,3.58626367,32.62523568,-24530532.43,-6688111.288,72,0,72,1.1727,79.76893333,80.25076667,80.85873333,81.34056667,79.16096667,78.67913333,78.07116667,0.326390163,524850508,175327209.2,1
12/17/2013,79.4013,79.9199,79.0535,79.2842,57475649,AAPL,80.19594,0.751593063,1.43,232.2504296,-39.39713351,3.446101142,20.31150642,-26867079.69,-7605375,68,32,36,0.8664,79.4192,79.7849,80.2856,80.6513,78.9185,78.5528,78.0521,0.266274238,467374859,175068419.1,-1
12/18/2013,78.5285,78.7785,76.9714,78.6813,141465807,AAPL,79.99265,0.746171808,2.4473,781.4000873,-58.38183251,3.373277231,-7.762034203,126247527.5,-1520912.34,64,28,36,2.3128,78.14373333,79.31606667,79.95083333,81.12316667,77.50896667,76.33663333,75.70186667,0.946212163,325909052,173992672.2,-1
12/19/2013,78.4999,78.5713,77.6757,77.7799,80239369,AAPL,79.65778,0.739580389,2.2229,-236.627276,-84.42436619,2.981198949,-15.12510584,-61568216.14,-4250437.934,60,24,36,1.0056,78.00896667,78.34223333,78.90456667,79.23783333,77.44663333,77.11336667,76.55103333,0.116346583,245669683,173073422.4,-1
12/20/2013,77.9185,78.8013,77.831,78.4314,109103435,AAPL,79.50064,0.734693186,2.4871,-1449.540703,-71.87331433,2.611474462,-13.47052377,25918109.62,-2879091.068,56,20,36,1.0214,78.35456667,78.87813333,79.32486667,79.84843333,77.90783333,77.38426667,76.93753333,0.618777698,354773118,173987294.6,1
12/23/2013,81.1428,81.5313,80.3942,81.4413,125326831,AAPL,79.55292,0.731863478,-0.6485,1008.937198,-13.88803267,2.303829116,43.20709883,105487916.6,2046850.873,52,16,36,3.0999,81.12226667,81.85033333,82.25936667,82.98743333,80.71323333,79.98516667,79.57613333,0.920851288,480099949,178796863.6,1
12/24/2013,81.4128,81.6971,80.8613,81.0956,41888735,AAPL,79.5832,0.728845926,-0.9014,1423.728369,-20.54789243,2.102187356,41.26465736,-18403378.19,1117264.588,48,12,36,0.8358,81.218,81.5747,82.0538,82.4105,80.7389,80.3822,79.9031,0.280330223,438211214,178619055.3,-1
12/26/2013,81.1571,81.3571,80.4822,80.5571,51002035,AAPL,79.61949,0.725885063,-0.48,-877.6377953,-30.92201587,1.691912579,26.48442696,-42269488.6,-854922.1591,44,8,36,0.8749,80.7988,81.1154,81.6737,81.9903,80.2405,79.9239,79.3656,0.085609784,387209179,178280386,-1
12/27/2013,80.5456,80.6299,79.9285,80.0128,56471317,AAPL,79.61306,0.722548836,-0.8086,50157,-35.64128066,1.270910184,5.736080404,-42896945.68,-2765980.207,40,4,36,0.7014,80.1904,80.4523,80.8918,81.1537,79.7509,79.489,79.0495,0.120188195,330737862,177898826.3,-1
12/30/2013,79.6371,80.0128,78.9029,79.2171,63407722,AAPL,79.61435,0.719278287,0.4257,-240.9780181,-52.47899782,0.849644461,-25.10944619,-27507719.74,-3890636.74,36,0,36,1.1099,79.3776,79.8523,80.4875,80.9622,78.7424,78.2677,77.6325,0.283088567,267330140,177268258.2,-1
12/31/2013,79.1671,80.1828,79.1428,80.1456,55819372,AAPL,79.66463,0.716504618,-0.8614,-776.9622991,-32.83111497,0.501877121,-10.298629,51826140,-1357987.175,32,0,32,1.04,79.82373333,80.50466667,80.86373333,81.54466667,79.46466667,78.78373333,78.42466667,0.964230769,323149512,177922514.5,1
7/1/2014,93.52,94.07,93.13,93.52,38223477,AAPL,91.575,0.527179642,-1.34,-1252.941176,-24.26614481,0.149162744,67.99100999,-6506123.745,3629118.96,40,0,40,1.14,93.57333333,94.01666667,94.51333333,94.95666667,93.07666667,92.63333333,92.13666667,0.414893617,895371494,187166629.4,1
7/3/2014,93.67,94.1,93.2,94.03,22891753,AAPL,91.922,0.526185751,-3.12,174.9090909,-1.573033708,-0.178195667,94.55793731,19330813.64,3943452.65,32,8,24,0.9,93.77666667,94.35333333,94.67666667,95.25333333,93.45333333,92.87666667,92.55333333,0.922222222,889798174,187289140.6,1
7/7/2014,94.14,95.99,94.1,95.968,56467939,AAPL,92.4278,0.52759112,-5.138,154.670913,-0.347003155,-0.201938467,185.6127853,55153341.48,6271175.034,28,4,24,1.96,95.35266667,96.60533333,97.24266667,98.49533333,94.71533333,93.46266667,92.82533333,0.988359788,946266113,188452969.9,1
7/9/2014,95.44,95.95,94.76,95.39,36436440,AAPL,93.3908,0.530063162,-5.03,179.6884735,-19.72027972,-0.112767019,150.6525543,2143320,5791796.943,96,64,32,1.19,95.36666667,95.97333333,96.55666667,97.16333333,94.78333333,94.17666667,93.59333333,0.529411765,917480875,188048250.7,1
7/10/2014,93.76,95.55,93.52,95.035,39685552,AAPL,93.8583,0.531193487,-4.135,181.6692913,-24.68531469,0.089099362,102.0053977,19549533,6417148.62,92,60,32,2.03,94.70166667,95.88333333,96.73166667,97.91333333,93.85333333,92.67166667,91.82333333,0.746305419,877795323,187900558.4,-1
7/11/2014,95.36,95.89,94.8625,95.22,34018228,AAPL,94.2903,0.532115806,-3.24,138.1206497,-22.0979021,0.467280413,117.2637584,-10346176.4,5655179.257,88,56,32,1.0275,95.32416667,95.78583333,96.35166667,96.81333333,94.75833333,94.29666667,93.73083333,0.347931873,911813551,187966780,1
7/14/2014,95.86,96.89,95.65,96.45,42810155,AAPL,94.7373,0.533128789,-3.52,127.8113879,-6.077348066,0.929404835,135.3614227,12428754.68,5963069.066,84,52,32,1.67,96.33,97.01,97.57,98.25,95.77,95.09,94.53,0.64516129,954623706,188519778.2,1
7/15/2014,96.8,96.85,95.03,95.32,45696176,AAPL,94.9763,0.532962153,-1.8,142.5198413,-21.68508287,1.318170135,92.90267493,-31133658.37,4276854.092,96,48,48,1.82,95.73333333,96.43666667,97.55333333,98.25666667,94.61666667,93.91333333,92.79666667,0.159340659,908927530,187984405.7,-1
7/16/2014,96.97,97.1,94.74,94.78,53502415,AAPL,95.1023,0.532161754,-1.3,160.7013575,-31.1409396,1.673370953,75.24782334,-51688773.81,1732961.785,92,44,48,2.36,95.54,96.34,97.9,98.7,93.98,93.18,91.62,0.016949153,855425115,187681307.7,-1
7/17/2014,95.03,95.279,92.57,93.0899,57298243,AAPL,95.06329,0.530430986,0.9401,299.69405,-54.93287671,1.916785751,7.237264732,-35305362.57,49401.5052,96,40,56,2.709,93.6463,94.7226,96.3553,97.4316,92.0136,90.9373,89.3046,0.191915836,798126872,186659575.6,-1
7/18/2014,93.62,94.74,93.02,94.43,49987593,AAPL,95.10329,0.529164309,1.538,278.4938776,-42.18009479,2.104340057,18.10844773,31968809.48,1500283.753,92,36,56,1.72,94.06333333,95.10666667,95.78333333,96.82666667,93.38666667,92.34333333,91.66666667,0.819767442,848114465,187379185.1,1
7/21/2014,94.99,95,93.72,93.939,39079002,AAPL,94.90039,0.52656933,1.411,582.0713578,-63.09381238,2.202005528,18.54360916,-25706656,263604.6184,88,32,56,1.28,94.21966667,94.71933333,95.49966667,95.99933333,93.43933333,92.93966667,92.15933333,0.17109375,809035463,187175989.2,-1
7/22/2014,94.68,94.89,94.12,94.72,55196597,AAPL,94.83739,0.524766155,0.67,505.3416667,-52.53863135,2.189599736,25.05442478,30824073.65,1652716.906,84,28,56,0.951,94.57666667,95.03333333,95.34666667,95.80333333,94.26333333,93.80666667,93.49333333,0.779220779,864232060,187634888.5,1
7/23/2014,95.42,97.88,95.17,97.19,92917719,AAPL,95.01739,0.524332127,-2.155,230.0296496,-12.99435028,2.027719986,92.74232434,45601684.97,3650397.353,80,24,56,3.16,96.74666667,98.32333333,99.45666667,101.0333333,95.61333333,94.03666667,92.90333333,0.745387454,957149779,190057890.7,1
7/24/2014,97.035,97.32,96.42,97.03,45728843,AAPL,95.21689,0.524000895,-1.81,266.1366667,-16.00753296,1.935010066,83.07957579,16259144.18,4223522.231,96,20,76,0.9,96.92333333,97.42666667,97.82333333,98.32666667,96.52666667,96.02333333,95.62666667,0.677777778,911420936,189982609.1,-1
7/25/2014,96.85,97.84,96.64,97.671,43469117,AAPL,95.46199,0.523924539,-1.221,392.6658837,-3.935969868,1.858863845,84.29472194,31225315.71,5450876.525,92,16,76,1.2,97.38366667,98.12733333,98.58366667,99.32733333,96.92733333,96.18366667,95.72733333,0.859166667,954890053,190269775,1
7/28/2014,97.82,99.24,97.55,99.02,55317689,AAPL,95.71899,0.523929231,-3.7,218.9673025,-3.298350825,1.850010939,114.5071963,40915450.44,7062902.669,88,12,76,1.69,98.60333333,99.65666667,100.2933333,101.3466667,97.96666667,96.91333333,96.27666667,0.869822485,1010207742,191033804.9,1
7/29/2014,99.33,99.44,98.25,98.38,43143095,AAPL,96.02499,0.524183748,-3.6,267.4280936,-15.4294032,1.749432457,105.4497935,-33716872.56,5209276.46,96,8,88,1.19,98.69,99.13,99.88,100.32,97.94,97.5,96.75,0.109243697,967064647,190754956.3,-1
7/30/2014,98.44,98.7,97.67,98.15,33010001,AAPL,96.36199,0.524595048,-5.0601,256.6966292,-18.77729258,1.467125185,79.72632182,-2243398.126,4870518.513,96,4,92,1.03,98.17333333,98.67666667,99.20333333,99.70666667,97.64666667,97.14333333,96.61666667,0.466019417,934054646,190677783.1,-1
7/31/2014,97.16,97.45,95.33,95.6,56842647,AAPL,96.613,0.524501649,-1.17,2055.552632,-55.89519651,1.235024821,9.387169138,-42363859.56,2723501.263,92,0,92,2.82,96.12666667,96.92333333,98.24666667,99.04333333,94.80333333,94.00666667,92.68333333,0.127358491,877211999,189200974.7,-1
8/1/2014,94.9,96.62,94.81,96.13,48511286,AAPL,96.783,0.52398101,-2.191,-2222.21875,-48.18049491,1.092111151,-2.837405695,22245506.84,3610865.178,88,0,88,1.81,95.85333333,96.89666667,97.66333333,98.70666667,95.08666667,94.04333333,93.27666667,0.729281768,925723285,189469918,1
8/4/2014,96.37,96.58,95.17,95.59,39958144,AAPL,96.9481,0.523426861,-0.87,2633.740741,-56.04075691,1.214076931,-6.938336194,-16153292.26,2712494.361,84,0,84,1.41,95.78,96.39,97.19,97.8,94.98,94.37,93.57,0.29787234,885765141,189245457.4,-1
8/5/2014,95.36,95.68,94.36,95.12,55932663,AAPL,96.9881,0.522203026,2.07,2091.5,-62.88209607,1.225922211,-38.70698006,8474645.909,2974410.347,80,0,80,1.32,95.05333333,95.74666667,96.37333333,97.06666667,94.42666667,93.73333333,93.10666667,0.575757576,829832478,188970445.9,-1
8/6/2014,94.75,95.48,94.71,94.96,38558342,AAPL,96.7651,0.51959161,2.07,380.2523929,-65.21106259,1.375687049,-40.64141544,-13520457.58,2224643.604,76,44,32,0.77,95.05,95.39,95.82,96.16,94.62,94.28,93.85,0.324675325,791274136,188905587.4,-1
8/7/2014,94.93,95.95,94.1,94.48,46711179,AAPL,96.5101,0.516821699,3.191,11542,-77.25856698,1.460199075,-48.95327787,-27521721.68,872536.0586,72,40,32,1.85,94.84333333,95.58666667,96.69333333,97.43666667,93.73666667,92.99333333,91.88666667,0.205405405,744562957,188669473.6,-1
8/8/2014,94.26,94.82,93.28,94.74,41865193,AAPL,96.217,0.513873508,4.28,752.9338327,-76.2987013,1.208249666,-70.00123533,37515562.56,2538128.211,68,36,32,1.54,94.28,95.28,95.82,96.82,93.74,92.74,92.2,0.948051948,786428150,188784682.7,1
8/11/2014,95.27,96.08,94.8355,95.99,36584844,AAPL,95.914,0.510911024,2.39,511.8110236,-56.00649351,1.028198178,-8.785838226,31293343.86,3845183.496,64,32,32,1.34,95.63516667,96.43483333,96.87966667,97.67933333,95.19033333,94.39066667,93.94583333,0.9276818,823012994,189267383.3,1
8/12/2014,96.04,96.88,95.61,95.97,33795352,AAPL,95.673,0.508292761,2.18,-330.3278689,-56.33116883,0.866778991,12.20140056,-14635782.36,3005139.576,60,28,32,1.27,96.15333333,96.69666667,97.42333333,97.96666667,95.42666667,94.88333333,94.15666667,0.283464567,789217642,189260341.9,-1
8/13/2014,96.15,97.24,96.04,97.24,31866088,AAPL,95.582,0.506492766,-1.64,2523.809524,-35.71428571,0.489847026,43.24513866,31866088,4317000.894,56,24,32,1.27,96.84,97.64,98.04,98.84,96.44,95.64,95.24,1,821083730,189682035.4,1
8/14/2014,97.33,97.57,96.8,97.5,28115566,AAPL,95.772,0.506170476,-1.37,-2876.608187,-31.49350649,0.181014759,60.71939682,23003644.91,5166393.82,52,20,32,0.77,97.29,97.78,98.06,98.55,97.01,96.52,96.24,0.909090909,849199296,189757210.7,1
8/15/2014,97.9,98.19,96.86,97.98,48951331,AAPL,95.957,0.505827888,-2.39,-389.4230769,-23.7012987,-0.130942767,77.2345413,33493015.95,6453967.577,48,16,32,1.33,97.67666667,98.49333333,99.00666667,99.82333333,97.16333333,96.34666667,95.83333333,0.842105263,898150627,189998201.9,1
8/18/2014,98.49,99.37,97.98,99.16,47572413,AAPL,96.314,0.506391924,-4.04,670.5128205,-4.545454545,-0.059747,147.1260756,33198014.83,7669606.11,44,12,32,1.39,98.83666667,99.69333333,100.2266667,101.0833333,98.30333333,97.44666667,96.91333333,0.848920863,945723040,190571129.5,1
8/19/2014,99.41,100.68,99.32,100.53,69399270,AAPL,96.855,0.507917705,-5.57,277.3109244,-2.027027027,0.061556845,228.7584693,54090607.5,9779651.662,40,8,32,1.52,100.1766667,101.0333333,101.5366667,102.3933333,99.67333333,98.81666667,98.31333333,0.889705882,1015122310,191529953.6,1
8/20/2014,100.44,101.09,99.95,100.57,52699192,AAPL,97.416,0.509531635,-6.09,133.6016097,-6.658130602,0.205456156,225.566066,4622736.14,9545246.408,96,4,92,1.14,100.5366667,101.1233333,101.6766667,102.2633333,99.98333333,99.39666667,98.84333333,0.543859649,1067821502,191550922.2,1
8/21/2014,100.57,100.94,100.11,100.58,33478198,AAPL,98.026,0.511381498,-5.84,137.5280899,-6.530089629,0.404623769,175.5653612,4436869.614,9313047.459,96,0,96,0.83,100.5433333,100.9766667,101.3733333,101.8066667,100.1466667,99.71333333,99.31666667,0.56626506,1101299700,191554251,1
8/22/2014,100.29,101.47,100.19,101.32,44183834,AAPL,98.684,0.51346965,-5.33,119.7207679,-1.831501832,0.568346171,160.2169056,33828247.91,10427374.77,92,0,92,1.28,100.9933333,101.7966667,102.2733333,103.0766667,100.5166667,99.71333333,99.23666667,0.8828125,1145483534,191879326,1
8/25/2014,101.79,102.17,101.28,101.54,40270173,AAPL,99.239,0.515014265,-5.57,110.2803738,-7.086614173,0.924062485,157.3051261,-16741532.6,9192424.416,96,56,40,0.89,101.6633333,102.0466667,102.5533333,102.9366667,101.1566667,100.7733333,100.2666667,0.292134831,1185753707,191966766.1,1
8/26/2014,101.42,101.5,100.86,100.889,33151984,AAPL,99.7309,0.516212793,-3.649,119.4130545,-14.40944882,1.242295595,115.4934053,-30147585.45,7404242.126,96,52,44,0.68,101.083,101.306,101.723,101.946,100.666,100.443,100.026,0.0453125,1152601723,191754219.9,-1
8/27/2014,101.02,102.57,100.7,102.13,52369011,AAPL,100.2199,0.517400457,-4.63,108.7712418,-4.736275565,1.508216046,122.1274923,27724770.53,8327902.52,92,48,44,1.87,101.8,102.9,103.67,104.77,101.03,99.93,99.16,0.764705882,1204970734,192398392.7,1
8/28/2014,101.59,102.78,101.56,102.25,68459801,AAPL,100.6949,0.518506062,-4.27,108.9347537,-5.578947368,1.975950128,114.1254419,8978334.557,8357467.613,96,44,52,1.22,102.1966667,102.8333333,103.4166667,104.0533333,101.6133333,100.9766667,100.3933333,0.56557377,1273430535,192478831.1,1
8/29/2014,102.86,102.9,102.2,102.5,44595247,AAPL,101.1469,0.519486609,-3.34,110.3072197,-4.96000992,2.309452966,106.2988525,-6370749.571,7688003.188,96,40,56,0.7,102.5333333,102.8666667,103.2333333,103.5666667,102.1666667,101.8333333,101.4666667,0.428571429,1318025782,192587865.9,1
9/2/2014,103.06,103.74,102.72,103.3,53564262,AAPL,101.5609,0.520274851,-2.77,108.8813097,-5.412054121,2.706590625,104.0700759,7351957.529,7672728.385,96,36,60,1.24,103.2533333,103.7866667,104.2733333,104.8066667,102.7666667,102.2333333,101.7466667,0.568627451,1371590044,193005928.4,1
9/3/2014,103.1,103.2,98.58,98.94,125420521,AAPL,101.4019,0.518110169,1.63,394.7647059,-62.33766234,3.052405841,24.64268147,-105874465.8,2511492.232,96,32,64,4.72,100.24,101.9,104.86,106.52,97.28,95.62,92.66,0.077922078,1246169523,187712284,-1
9/4/2014,98.85,100.09,97.79,98.12,85718221,AAPL,101.1569,0.515515904,2.46,1040.483871,-80.97982709,3.197957118,-12.59026686,-61120818.45,-380885.5548,92,28,64,2.3,98.66666667,99.54333333,100.9666667,101.8433333,97.24333333,96.36666667,94.94333333,0.143478261,1160451302,187001864.1,-1
9/5/2014,98.8,99.39,98.31,98.97,58457035,AAPL,100.9959,0.513370163,2.35,688.989899,-69.33139535,3.167069566,-12.30803569,12990452.22,226902.5317,88,24,64,1.27,98.89,99.47,99.97,100.55,98.39,97.81,97.31,0.611111111,1218908337,187508269.4,1
9/8/2014,99.3,99.31,98.05,98.36,46356742,AAPL,100.6999,0.510554651,3.18,-705.125,-90.42016807,2.951163978,-24.14052515,-23546281.65,-853696.7591,84,20,64,1.26,98.57333333,99.09666667,99.83333333,100.3566667,97.83666667,97.31333333,96.57666667,0.246031746,1172551595,187222550.3,-1
9/9/2014,99.08,103.08,96.14,97.99,189846255,AAPL,100.3449,0.507458256,2.899,-168.1496063,-75.65789474,2.74556868,-17.54126122,-88631392.82,-4843592.069,80,16,64,6.94,99.07,102,106.01,108.94,95.06,92.13,88.12,0.266570605,982705340,186508407.2,-1
9/10/2014,98.01,101.11,97.76,101,100869587,AAPL,100.356,0.506241723,1.13,1683.953488,-36.05263158,2.464485026,-2.020138493,94245315.61,-339550.7737,76,12,64,3.35,99.95666667,102.1533333,103.3066667,105.5033333,98.80333333,96.60666667,95.45333333,0.967164179,1083574927,189606860.7,1
9/11/2014,100.41,101.44,99.62,101.43,62399743,AAPL,100.286,0.504634138,0.82,901.2941176,-30.39473684,2.118797858,15.49970648,61714031.54,2481066.626,72,8,64,1.82,100.83,102.04,102.65,103.86,100.22,99.01,98.4,0.994505495,1145974670,189872523,1
9/12/2014,101.21,102.19,101.08,101.66,64096903,AAPL,100.227,0.503092771,0.84,2103.235294,-27.36842105,1.844215827,33.80624706,2887247.883,2499529.411,68,4,64,1.11,101.6433333,102.2066667,102.7533333,103.3166667,101.0966667,100.5333333,99.98666667,0.522522523,1210071573,190017867.4,1
9/15/2014,102.81,103.05,101.44,101.63,61316516,AAPL,100.14,0.501421119,1.67,7701.111111,-27.76315789,1.350887327,42.0479496,-46844294.83,256628.2928,64,0,64,1.61,102.04,102.64,103.65,104.25,101.03,100.43,99.42,0.118012422,1148755057,189999772.9,-1
9/16/2014,99.8,101.26,98.89,100.86,66908133,AAPL,99.896,0.498975815,-1.92,-23900,-37.89473684,0.808515709,-14.08340422,44323109.2,2259650.166,60,0,60,2.74,100.3366667,101.7833333,102.7066667,104.1533333,99.41333333,97.96666667,97.04333333,0.831223629,1081846924,189492843.2,-1
9/17/2014,101.27,101.8,100.5922,101.58,60926498,AAPL,100.16,0.499050704,-3.46,-1165.454545,-28.42105263,0.293710062,19.68117367,38731052.46,3917441.19,56,0,56,1.2078,101.3240667,102.0559333,102.5318667,103.2637333,100.8481333,100.1162667,99.64033333,0.817850638,1142773422,189927773.6,1
9/18/2014,101.93,102.35,101.56,101.79,37299435,AAPL,100.527,0.499629407,-2.82,-1413.043478,-25.65789474,-0.365763294,45.5451791,-15580776.65,3031158.556,52,0,52,0.79,101.9,102.24,102.69,103.03,101.45,101.11,100.66,0.291139241,1180072857,190004884,1
9/19/2014,102.29,102.35,100.88,100.96,70902406,AAPL,100.726,0.499369063,-2.6,-405.8441558,-36.57894737,-0.388708908,24.86869891,-63185137.32,21326.90729,48,68,-20,1.47,101.3966667,101.9133333,102.8666667,103.3833333,100.4433333,99.92666667,98.97333333,0.054421769,1109170451,189426742.8,-1
9/22/2014,101.8,102.14,100.58,101.06,52788426,AAPL,100.996,0.499455154,-3.07,-247.7678571,-35.26315789,-0.266314096,21.35285465,-20303240.77,-902517.0833,44,64,-20,1.56,101.26,101.94,102.82,103.5,100.38,99.7,98.82,0.307692308,1161958877,189479029.3,1
9/23/2014,100.6,102.94,100.54,102.64,63402196,AAPL,101.461,0.500505707,-1.64,192.7027027,-7.932011331,-0.172280327,99.63010201,47551647,1299944.933,40,60,-20,2.4,102.04,103.54,104.44,105.94,101.14,99.64,98.74,0.875,1225361073,190470276.7,1
9/24/2014,102.16,102.85,101.2,101.75,60171828,AAPL,101.536,0.499641626,-0.32,196.4187328,-19.16426513,0.081018053,86.57121952,-20057276,329162.1578,36,56,-20,1.65,101.9333333,102.6666667,103.5833333,104.3166667,101.0166667,100.2833333,99.36666667,0.333333333,1165189245,189948521.8,-1
9/25/2014,100.51,100.71,97.72,97.87,100091990,AAPL,101.18,0.496647008,3.79,-570.9090909,-75.07204611,0.404447746,-185.0755945,-90049315.42,-3778950.48,32,52,-20,4.03,98.76666667,99.81333333,101.7566667,102.8033333,96.82333333,95.77666667,93.83333333,0.050167224,1065097255,186131746.2,-1
9/26/2014,98.53,100.75,98.4,100.75,62370501,AAPL,101.089,0.494986151,0.88,383.2635983,-33.57348703,0.401817939,-59.59979254,62370501,-772157.2164,28,48,-20,2.88,99.96666667,101.5333333,102.3166667,103.8833333,99.18333333,97.61666667,96.83333333,1,1127467756,187967109.8,1
9/29/2014,98.65,100.435,98.63,100.11,49766312,AAPL,100.937,0.493032884,0.75,432.0754717,-42.79538905,0.322281659,-69.47587299,31844925.41,710437.4551,24,44,-20,2.12,99.725,100.82,101.53,102.625,99.015,97.92,97.21,0.819944598,1077701444,187650976.4,-1
9/30/2014,100.81,101.54,100.53,100.75,55264139,AAPL,100.926,0.491776409,0.83,-2716,-43.15196998,0.265545005,37.0550684,-31188672.5,-739522.0948,20,40,-20,1.43,100.94,101.35,101.95,102.36,100.34,99.93,99.33,0.217821782,1132965583,188004278.3,1
10/1/2014,100.59,100.69,98.7,99.18,51491286,AAPL,100.686,0.489409341,2.61,-282.6666667,-72.60787992,0.179375105,-70.67304879,-26651268.63,-1917328.761,16,36,-20,2.05,99.52333333,100.3466667,101.5133333,102.3366667,98.35666667,97.53333333,96.36666667,0.24120603,1081474297,187201883.1,-1
10/2/2014,99.27,100.22,98.04,99.9,47757828,AAPL,100.497,0.487309093,1.06,-389.2045455,-59.09943715,0.168460061,-81.79155098,33737181.25,-296669.2083,12,32,-20,2.18,99.38666667,100.7333333,101.5666667,102.9133333,98.55333333,97.20666667,96.37333333,0.853211009,1129232125,187548582.4,1
10/3/2014,99.44,100.21,99.04,99.62,43469585,AAPL,100.363,0.485480439,1.44,-340.7960199,-64.35272045,0.122957197,-67.2866262,-371534.9145,-300072.195,8,28,-20,1.17,99.62333333,100.2066667,100.7933333,101.3766667,99.03666667,98.45333333,97.86666667,0.495726496,1085762540,187426745.7,-1
10/6/2014,99.95,100.65,99.42,99.62,37051182,AAPL,100.219,0.483614567,3.02,-552.4193548,-63.60153257,0.04447736,-53.66644217,-25002017.12,-1422887.878,4,24,-20,1.23,99.89666667,100.3733333,101.1266667,101.6033333,99.14333333,98.66666667,97.91333333,0.162601626,1085762540,187426745.7,-1
10/7/2014,99.43,100.12,98.73,98.75,42094183,AAPL,99.83,0.480585424,3,-216.6077739,-80.26819923,0.063996122,-106.6562481,-40882839.6,-3216522.053,0,20,-20,1.39,99.2,99.67,100.59,101.06,98.28,97.81,96.89,0.014388489,1043668357,187059129.4,-1
10/8/2014,98.76,101.11,98.31,100.8,57404674,AAPL,99.735,0.478992262,-2.93,-805.0505051,-40.99616858,0.16550869,-37.15969492,44693639.04,-1038787.451,0,16,-16,2.8,100.0733333,101.8366667,102.8733333,104.6366667,99.03666667,97.27333333,96.23666667,0.889285714,1101073031,188250821.3,1
10/9/2014,101.54,102.38,100.61,101.02,77376525,AAPL,100.05,0.479348686,-0.27,13650,-36.7816092,-0.228874668,53.93294365,-41529773.31,-2879286.813,12,12,0,1.77,101.3366667,102.0633333,103.1066667,103.8333333,100.2933333,99.56666667,98.52333333,0.231638418,1178449556,188419698.7,1
10/10/2014,100.69,102.03,100.3,100.73,66331592,AAPL,100.048,0.478201318,-0.62,-2451.515152,-42.33716475,-0.587264885,31.95350251,-33357505.8,-4264660.408,8,8,0,1.73,101.02,101.74,102.75,103.47,100.01,99.29,98.28,0.248554913,1112117964,188229279.3,-1
10/13/2014,101.33,101.78,99.81,99.81,53583368,AAPL,100.018,0.476917168,0.94,-230.0353357,-59.96168582,-0.385928719,-2.84575689,-53583368,-6506419.85,4,4,0,1.97,100.4666667,101.1233333,102.4366667,103.0933333,99.15333333,98.49666667,97.18333333,0,1058534596,187739884.9,-1
10/14/2014,100.39,100.52,98.57,98.75,63688562,AAPL,99.818,0.474829381,0.43,-217,-79.92202729,-0.639843753,-92.92451785,-51930673.63,-8571158.664,0,0,0,1.95,99.28,99.99,101.23,101.94,98.04,97.33,96.09,0.092307692,994846034,187063501,-1
10/15/2014,97.97,99.15,95.18,97.54,100933600,AAPL,99.654,0.472908722,2.36,-1972.727273,-67.22222222,-0.875637265,-230.0326704,19068060.45,-7314830.519,12,44,-32,3.97,97.29,99.4,101.26,103.37,95.43,93.32,91.46,0.594458438,893912434,185826745,-1
10/16/2014,95.55,97.72,95.41,96.26,72154523,AAPL,99.29,0.470050174,3.36,-80.84632517,-85,-1.063463894,-254.3869214,-19053791.79,-7848419.669,8,96,-88,2.31,96.46333333,97.51666667,98.77333333,99.82666667,95.20666667,94.15333333,92.89666667,0.367965368,821757911,184879874.1,-1
10/17/2014,97.5,99,96.81,97.67,68179688,AAPL,99.095,0.468012867,1.95,-206.557377,-65.41666667,-0.987090637,-117.7247032,-14632170.48,-8156771.98,4,92,-88,2.74,97.82666667,98.84333333,100.0166667,101.0333333,96.65333333,95.63666667,94.46333333,0.392694064,889937599,185878558.5,1
10/20/2014,98.315,99.96,98.22,99.76,77517279,AAPL,99.109,0.466982648,-1.01,-655.5555556,-36.38888889,-0.944640469,-21.7314131,59697214.86,-5072499.844,0,88,-88,2.29,99.31333333,100.4066667,101.0533333,102.1466667,98.66666667,97.57333333,96.92666667,0.885057471,967454878,187537318.7,1
10/21/2014,103.02,103.02,101.27,102.47,94623904,AAPL,99.481,0.46764825,-1.67,279.6352584,-7.015306122,-0.794951668,142.0248836,35146021.49,-3244385.234,20,84,-64,3.26,102.2533333,103.2366667,104.0033333,104.9866667,101.4866667,100.5033333,99.73666667,0.685714286,1062078782,190107795.7,1
10/22/2014,102.84,104.11,102.6,102.99,68263146,AAPL,99.7,0.467604003,-1.97,291.2621359,-12.54199328,-0.668034124,176.0761828,-33001388.46,-4596976.292,96,80,16,1.64,103.2333333,103.8666667,104.7433333,105.3766667,102.3566667,101.7233333,100.8466667,0.258278146,1130341928,190454207.7,1
10/23/2014,104.08,105.051,103.63,104.83,71074674,AAPL,100.081,0.468325851,-4.1,208.0614203,-2.238881572,-0.310035315,200.3272688,48966999.19,-2162250.129,96,76,20,2.061,104.5036667,105.3773333,105.9246667,106.7983333,103.9563333,103.0826667,102.5353333,0.844475721,1201416602,191724014.5,1
10/24/2014,105.18,105.49,104.53,105.22,47053916,AAPL,100.53,0.469357618,-5.41,200.5357143,-2.618816683,-0.187250116,183.3318701,20586088.25,-1128234.747,96,72,24,0.96,105.08,105.63,106.04,106.59,104.67,104.12,103.71,0.71875,1248470518,191899069.6,1
10/27/2014,104.85,105.48,104.7,105.11,34187701,AAPL,101.06,0.470750761,-6.36,176.572327,-3.685741998,-0.138569708,148.6136313,1753215.436,-997259.7381,96,68,28,0.78,105.0966667,105.4933333,105.8766667,106.2733333,104.7133333,104.3166667,103.9333333,0.525641026,1214282817,191863328.8,-1
10/28/2014,105.4,106.74,105.35,106.74,48060949,AAPL,101.859,0.473383118,-9.2,181.986532,0,0.0084387,160.972117,48060949,1232658.845,92,64,28,1.63,106.2766667,107.2033333,107.6666667,108.5933333,105.8133333,104.8866667,104.4233333,1,1262343766,192608637,1
10/29/2014,106.65,107.37,106.36,107.34,52687879,AAPL,102.839,0.476829392,-11.08,177.056962,-0.246103363,0.422019141,148.7965218,49557905.99,3429260.991,96,60,36,1.01,107.0233333,107.6866667,108.0333333,108.6966667,106.6766667,106.0133333,105.6666667,0.97029703,1315031645,192904802.7,1
10/30/2014,106.959,107.35,105.9,106.98,40654793,AAPL,103.911,0.480665427,-9.31,179.04,-3.199343724,0.96243074,115.9653577,19906829.68,4178241.387,96,56,40,1.45,106.7433333,107.5866667,108.1933333,109.0366667,106.1366667,105.2933333,104.6866667,0.744827586,1274376852,192768453.5,-1
10/31/2014,108.01,108.04,107.21,108,44639285,AAPL,104.944,0.484305627,-8.24,149.0842491,-0.311041991,1.512810205,116.2771126,40336703.31,5821807.841,92,52,40,1.06,107.75,108.29,108.58,109.12,107.46,106.92,106.63,0.951807229,1319016137,193194066.4,1
11/3/2014,108.22,110.3,108.01,109.4,52282550,AAPL,105.908,0.487619425,-6.93,127.7934272,-5.952380952,2.535353458,121.8435203,11187095.85,6065684.569,96,48,48,2.3,109.2366667,110.4633333,111.5266667,112.7533333,108.1733333,106.9466667,105.8833333,0.6069869,1371298687,193871803.1,1
11/4/2014,109.36,109.49,107.72,108.6,41574365,AAPL,106.521,0.489307653,-5.61,123.0560579,-11.24338624,3.40305466,92.03269256,-234883.4181,5779295.115,96,44,52,1.77,108.6033333,109.4866667,110.3733333,111.2566667,107.7166667,106.8333333,105.9466667,0.497175141,1329724322,193567785.9,-1
11/5/2014,109.1,109.3,108.125,108.86,37435905,AAPL,107.108,0.490866823,-4.03,110.0793651,-9.670920081,4.113574571,83.61234708,9398801.681,5943818.141,92,40,52,1.175,108.7616667,109.3983333,109.9366667,110.5733333,108.2233333,107.5866667,107.0483333,0.625531915,1367160227,193657411.4,1
11/6/2014,108.6,108.79,107.8,108.7,34968457,AAPL,107.495,0.491508201,-3.48,112.9646419,-11.86063751,4.411392542,70.75434626,28610555.73,6974124.396,88,36,52,1.06,108.43,109.06,109.42,110.05,108.07,107.44,107.08,0.909090909,1332191770,193606015.5,-1
11/7/2014,108.75,109.32,108.55,109.01,33691535,AAPL,107.874,0.492109843,-3.9,115.4594595,-10.67880795,4.733417231,69.69476797,6563286.039,6955449.925,84,32,52,0.77,108.96,109.37,109.73,110.14,108.6,108.19,107.83,0.597402597,1365883305,193702100,1
11/10/2014,109.02,109.33,108.67,108.83,27195547,AAPL,108.246,0.492671514,-2.09,125.3144654,-13.00884956,4.815604737,59.27072491,-14009827.24,6002482.78,80,28,52,0.66,108.9433333,109.2166667,109.6033333,109.8766667,108.5566667,108.2833333,107.8966667,0.242424242,1338687758,193657194,-1
11/11/2014,108.7,109.75,108.4,109.7,27442252,AAPL,108.542,0.492895043,-2.36,123.9940387,-5.309734513,4.889096611,55.61907517,25409492.59,6884619.591,76,24,52,1.35,109.2833333,110.1666667,110.6333333,111.5166667,108.8166667,107.9333333,107.4666667,0.962962963,1366130010,193876570.6,1
11/12/2014,109.38,111.43,109.37,111.25,46942431,AAPL,108.933,0.493555498,-4.27,125.0778816,-1.448109413,4.989112049,64.51758063,38738899.37,8332541.4,72,20,52,2.06,110.6833333,111.9966667,112.7433333,114.0566667,109.9366667,108.6233333,107.8766667,0.912621359,1413072441,194539841.1,1
11/13/2014,111.8,113.45,111.6,112.82,59522855,AAPL,109.517,0.495086573,-4.82,121.1842105,-4.359861592,5.059275579,78.66910514,18982964.57,8816651.545,96,16,80,2.2,112.6233333,113.6466667,114.4733333,115.4966667,111.7966667,110.7733333,109.9466667,0.659459459,1472595296,195379849,1
11/14/2014,113.15,114.19,113.05,114.18,44063595,AAPL,110.135,0.496770059,-4.78,116.5380375,-0.065832785,5.119278527,82.11671321,43290549.47,10383646.91,96,12,84,1.37,113.8066667,114.5633333,114.9466667,115.7033333,113.4233333,112.6666667,112.2833333,0.99122807,1516658891,195911018,1
11/17/2014,114.27,117.28,113.3,113.99,46746712,AAPL,110.594,0.497731086,-5.39,123.3103448,-17.99781182,5.235220297,83.34543964,-30538053.07,8523569.633,96,8,88,3.98,114.8566667,116.4133333,118.8366667,120.3933333,112.4333333,110.8766667,108.4533333,0.173366834,1469912179,195833229.7,-1
11/18/2014,113.94,115.69,113.89,115.47,44223978,AAPL,111.281,0.499709081,-6.61,120.7872079,-9.901531729,5.219682345,76.10169814,33413672.27,9654937.936,96,4,92,1.8,115.0166667,116.1433333,116.8166667,117.9433333,114.3433333,113.2166667,112.5433333,0.877777778,1514136157,196407415.9,1
11/19/2014,115.44,115.74,113.8,114.67,41869160,AAPL,111.862,0.501194212,-5.97,127.6983095,-14.27789934,4.943880075,65.31636475,-4316408.247,9019876.745,92,0,92,1.94,114.7366667,115.6733333,116.6766667,117.6133333,113.7333333,112.7966667,111.7933333,0.448453608,1472266997,196117337.7,-1
11/20/2014,114.91,116.86,114.85,116.31,43395537,AAPL,112.623,0.503477956,-7.3,125.631769,-5.306345733,4.755742691,73.43767202,19646735.66,9502915.787,88,0,88,2.19,116.0066667,117.1633333,118.0166667,119.1733333,115.1533333,113.9966667,113.1433333,0.726368159,1515662534,196737976.8,1
11/21/2014,117.51,117.57,116.03,116.47,57179298,AAPL,113.369,0.505679438,-7.64,130.1272984,-5.923532579,4.476561131,74.32219079,-24505413.43,7957082.64,84,0,84,1.54,116.69,117.35,118.23,118.89,115.81,115.15,114.27,0.285714286,1572841832,196816634.6,1
11/24/2014,116.85,118.77,116.62,118.625,47450824,AAPL,114.3485,0.508911433,-8.925,113.2668329,-0.733434497,4.385434347,82.91539421,41050480.3,9461327.989,96,0,96,2.3,118.005,119.39,120.155,121.54,117.24,115.855,115.09,0.93255814,1620292656,197694599.1,1
11/25/2014,119.07,119.75,117.45,117.6,68840440,AAPL,115.1385,0.511278187,-6.35,126.9450801,-10.36144578,4.393388039,77.62025246,-59861252.17,6310301.616,96,0,96,2.3,118.2666667,119.0833333,120.5666667,121.3833333,116.7833333,115.9666667,114.4833333,0.065217391,1551452216,197099771.2,-1
11/26/2014,117.94,119.1,117.83,119,40831886,AAPL,115.9135,0.513574861,-6.18,121.3106796,-3.614457831,4.675334292,74.10338279,34401667.73,7587181.895,96,0,96,1.5,118.6433333,119.4566667,119.9133333,120.7266667,118.1866667,117.3733333,116.9166667,0.921259843,1592284102,197585865.1,1
11/28/2014,119.27,119.4,118.05,118.93,24814402,AAPL,116.5245,0.515137009,-4.75,122.8326613,-3.951807229,4.924712766,67.42764976,7536225.793,7584865.708,92,0,92,1.35,118.7933333,119.5366667,120.1433333,120.8866667,118.1866667,117.4433333,116.8366667,0.651851852,1567469700,197571268.4,-1
12/1/2014,118.81,119.25,111.27,115.07,83814037,AAPL,116.6135,0.514374313,-1.08,195.2724359,-22.55421687,5.025934398,21.69801304,-3991144.619,7058683.42,88,0,88,7.98,115.1966667,119.1233333,123.1766667,127.1033333,111.1433333,107.2166667,103.1633333,0.476190476,1483655663,194850994.4,-1
12/2/2014,113.5,115.75,112.75,114.63,59348940,AAPL,116.6775,0.513501235,0.84,229.5131846,-24.6746988,4.949224335,9.817349033,15035064.8,7421246.21,84,0,84,3,114.3766667,116.0033333,117.3766667,119.0033333,113.0033333,111.3766667,110.0033333,0.626666667,1424306723,194624058.4,-1
12/3/2014,115.75,116.35,115.11,115.93,43063440,AAPL,116.7235,0.512565947,-1.26,236.4316239,-18.40963855,4.720239117,23.15212341,13891432.26,7715345.576,80,0,80,1.72,115.7966667,116.4833333,117.0366667,117.7233333,115.2433333,114.5566667,114.0033333,0.661290323,1467370163,195112433.8,1
12/4/2014,115.77,117.2,115.29,115.49,42155776,AAPL,116.8055,0.511785961,0.82,355.6179775,-20.53012048,4.614408961,22.02328825,-33327341.24,5849768.902,76,4,72,1.91,115.9933333,116.6966667,117.9033333,118.6066667,114.7866667,114.0833333,112.8766667,0.104712042,1425214387,194952436,-1
12/5/2014,115.99,116.08,114.64,115,38318895,AAPL,116.6745,0.510083942,1.47,992.0731707,-22.89156627,4.332765937,8.674813003,-19159447.5,4712986.338,72,0,72,1.44,115.24,115.84,116.68,117.28,114.4,113.8,112.96,0.25,1386895492,194789856.9,-1
12/8/2014,114.1,114.648,111.62,112.4,57664850,AAPL,116.2675,0.507176257,6.225,-511.6352201,-35.42168675,4.068436404,-27.98660267,-27956406.8,3228013.922,68,0,68,3.38,112.8893333,114.1586667,115.9173333,117.1866667,111.1306667,109.8613333,108.1026667,0.257595773,1329230642,193486129.9,-1
12/9/2014,110.19,114.3,109.35,114.12,60208036,AAPL,115.817,0.504114424,3.48,-620.3703704,-27.13253012,3.670953203,-37.96940573,55829269.75,5618980.096,64,4,60,4.95,112.59,115.83,117.54,120.78,110.88,107.64,105.93,0.963636364,1389438678,194407462.8,1
12/10/2014,114.41,114.85,111.54,111.95,44565318,AAPL,115.252,0.500558232,7.05,-307.9044118,-37.59036145,3.262584097,-40.40682467,-33524967.32,3839709.759,60,0,60,3.31,112.78,114.02,116.09,117.33,110.71,109.47,107.4,0.123867069,1344873360,193560050.1,-1
12/11/2014,112.26,113.8,111.34,111.62,41471578,AAPL,114.514,0.496278838,7.31,-143.6034115,-39.18072289,2.45833117,-53.71621444,-32030893.58,2209227.788,56,4,52,2.46,112.2533333,113.1666667,114.7133333,115.6266667,110.7066667,109.7933333,108.2466667,0.113821138,1303401782,193437802.5,-1
12/12/2014,110.46,111.87,109.58,109.73,56028138,AAPL,113.594,0.491229403,5.34,-97.55192878,-48.28915663,1.705641777,-90.79906686,-48688207.26,-104291.9874,52,0,52,2.29,110.3933333,111.2066667,112.6833333,113.4966667,108.9166667,108.1033333,106.6266667,0.065502183,1247373644,192489108.9,-1
12/15/2014,110.7,111.6,106.35,108.225,67218082,AAPL,112.9095,0.487200505,6.405,-42.5,-55.54216867,0.64270509,-121.7231636,-19205166.29,-972513.5468,48,8,40,5.25,108.725,111.1,113.975,116.35,105.85,103.475,100.6,0.357142857,1180155562,191567180.4,-1
12/16/2014,106.37,110.16,106.26,106.745,60790733,AAPL,112.121,0.482739101,9.185,-40.71856287,-62.6746988,-0.519856887,-136.713037,-45670986.59,-3004262.322,44,96,-52,3.9,107.7216667,109.1833333,111.6216667,113.0833333,105.2833333,103.8216667,101.3833333,0.124358974,1119364829,190735854.1,-1
12/17/2014,107.12,109.84,106.82,109.41,53411773,AAPL,111.469,0.478908478,6.08,-59.28050052,-48.97058824,-1.174702173,-110.2559825,38201797.91,-1131259.584,40,96,-56,3.095,108.69,110.56,111.71,113.58,107.54,105.67,104.52,0.857615894,1172776602,192069334.6,1
12/18/2014,111.87,112.65,110.66,112.65,59006218,AAPL,111.185,0.47668934,2.35,-142.1178344,-33.08823529,-1.678332701,-42.16742523,59006218,1602262.126,36,92,-56,3.24,111.9866667,113.3133333,113.9766667,115.3033333,111.3233333,109.9966667,109.3333333,1,1231782820,193816708.2,1
12/19/2014,112.26,113.24,111.66,111.78,88429770,AAPL,110.863,0.474313546,0.62,-271.2765957,-36.88888889,-2.32751654,-36.45741654,-74997399.87,-1879540.694,32,88,-56,1.58,112.2266667,112.7933333,113.8066667,114.3733333,111.2133333,110.6466667,109.6333333,0.075949367,1143353050,193133761.9,-1
12/22/2014,112.16,113.49,111.97,112.94,45167549,AAPL,110.917,0.473547756,1.18,-596.7455621,-23.40659341,-2.83888592,-19.480657,12480506.96,-1226811.255,28,84,-56,1.71,112.8,113.63,114.32,115.15,112.11,111.28,110.59,0.638157895,1188520599,193602489.4,1
12/23/2014,113.23,113.33,112.46,112.54,26028419,AAPL,110.759,0.471888445,-0.59,-259.1445428,-25.6043956,-3.249382213,-14.13088386,-21241583.32,-2136573.622,24,80,-56,0.87,112.7766667,113.0933333,113.6466667,113.9633333,112.2233333,111.9066667,111.3533333,0.091954023,1162492180,193510304.4,-1
12/24/2014,112.58,112.71,112.01,112.01,14479611,AAPL,110.765,0.470921766,-0.39,-252.4425287,-28.51648352,-3.353216874,-19.94557634,-14479611,-2697620.775,20,76,-56,0.7,112.2433333,112.4766667,112.9433333,113.1766667,111.7766667,111.5433333,111.0766667,0,1148012569,193442113.6,-1
12/26/2014,112.1,114.52,112.01,113.99,33720951,AAPL,111.002,0.470945446,-4.26,-1065.841584,-12.23653396,-3.570094617,15.54735414,19480230.66,-1689536.619,16,72,-56,2.51,113.5066667,115.0033333,116.0166667,117.5133333,112.4933333,110.9966667,109.9833333,0.788844622,1181733520,194038198.6,1
12/29/2014,113.79,114.77,113.7,113.91,27598920,AAPL,111.42,0.471723392,-5.685,712.9139073,-5.930599369,-3.553154506,35.70696538,-16765699.07,-2374816.73,12,68,-56,1.07,114.1266667,114.5533333,115.1966667,115.6233333,113.4833333,113.0566667,112.4133333,0.196261682,1154134600,194018829.3,-1
12/30/2014,113.64,113.92,112.11,112.52,29881477,AAPL,111.8495,0.472529879,-5.775,-565.3125,-14.70031546,-3.421164134,8.394277714,-16344012.28,-3009780.165,8,64,-56,1.81,112.85,113.59,114.66,115.4,111.78,111.04,109.97,0.226519337,1124253123,193654197.1,-1
12/31/2014,112.82,113.13,110.21,110.38,41403351,AAPL,112.213,0.473035152,-0.97,-576.1146497,-28.20189274,-3.059777028,-27.73123096,-36582412.87,-4535808.924,4,60,-56,2.92,111.24,112.27,114.16,115.19,109.35,108.32,106.43,0.058219178,1082849772,192866753.3,-1
6/22/2015,127.49,128.06,127.08,127.61,34039345,AAPL,127.597,0.430732818,-0.19,-165.5319149,-10.42579837,-1.735146493,-53.35421313,2778722.041,-2588327.312,20,64,-44,1.46,127.5833333,128.0866667,128.5633333,129.0666667,127.1066667,126.6033333,126.1266667,0.540816327,1462836716,203318039.8,1
6/24/2015,127.21,129.8,127.12,128.11,55280855,AAPL,127.481,0.428896831,0.48,-384.8,-7.821405953,-1.811226257,-8.301737738,-14439029.29,-3786006.128,12,56,-44,2.77,128.3433333,129.5666667,131.0233333,132.2466667,126.8866667,125.6633333,124.2066667,0.369402985,1487848708,203650458.7,1
6/30/2015,125.57,126.12,124.86,125.425,44370682,AAPL,126.8735,0.423990083,1.875,-122.8654124,-15.25016036,-1.663428347,-92.82331208,-4577927.508,-7872900.338,0,96,-96,1.59,125.4683333,126.0766667,126.7283333,127.3366667,124.8166667,124.2083333,123.5566667,0.448412698,1407053022,202697008.6,1
7/1/2015,126.9,126.94,125.99,126.6,30238811,AAPL,126.8035,0.423049842,1.28,-272.361809,-11.48171905,-1.560118118,-39.39484355,8594188.389,-7124396.305,0,92,-92,1.515,126.51,127.03,127.46,127.98,126.08,125.56,125.13,0.642105263,1437291833,202980290.3,1
7/10/2015,121.94,123.85,121.21,123.28,61354474,AAPL,124.7355,0.41201429,3.47,-221.9879518,-21.16883117,-1.298022409,-121.6544467,34860496.59,-6169686.277,0,96,-96,3.78,122.78,124.35,125.42,126.99,121.71,120.14,119.07,0.784090909,1257071461,201261675.4,1
7/13/2015,125.03,125.755,124.32,125.66,41440538,AAPL,124.6265,0.41098374,-1.13,-448.2051282,-13.44155844,-1.46309429,-27.54210249,35953637.5,-4254989.742,16,92,-76,2.475,125.245,126.17,126.68,127.605,124.735,123.81,123.3,0.933797909,1298511999,202061711.8,1
7/15/2015,125.72,127.15,125.58,126.82,33649200,AAPL,124.874,0.410455563,-0.22,-687.5968992,-9.675324675,-1.697937957,20.3802962,19503676.43,-3187342.999,8,84,-76,1.57,126.5166667,127.4533333,128.0866667,129.0233333,125.8833333,124.9466667,124.3133333,0.789808917,1300393060,202373213.7,1
7/16/2015,127.74,128.57,127.35,128.51,36222447,AAPL,125.065,0.410422779,-2.07,1045.544554,-2.284768212,-1.457608524,77.42184486,32659583.36,-1557937.256,4,80,-76,1.75,128.1433333,128.9366667,129.3633333,130.1566667,127.7166667,126.9233333,126.4966667,0.950819672,1336615507,202855913.1,1
7/17/2015,129.08,129.62,128.31,129.62,46164710,AAPL,125.383,0.410807321,-3.62,406.6202091,0,-1.202167995,105.064617,46164710,611273.9834,0,76,-76,1.31,129.1833333,130.0566667,130.4933333,131.3666667,128.7466667,127.8733333,127.4366667,1,1382780217,203254658.9,1
7/20/2015,130.97,132.97,130.7,132.07,58900203,AAPL,125.99,0.412138742,-6.38,187.2679045,-2.649396526,-1.049833587,176.123369,12195196.22,1137815.903,32,72,-40,3.35,131.9133333,133.1266667,134.1833333,135.3966667,130.8566667,129.6433333,128.5866667,0.603524229,1441680420,204367955.5,1
7/21/2015,132.85,132.92,130.32,130.75,76756427,AAPL,126.496,0.413128616,-8.18,248.3568075,-6.535178098,-0.983998127,138.6208239,-51367762.68,-1248801.306,96,68,28,2.6,131.33,132.34,133.93,134.94,129.74,128.73,127.14,0.165384615,1364923993,203600798,-1
7/22/2015,121.99,125.5,121.99,125.22,115450607,AAPL,126.761,0.413304447,-5.15,-873.1884058,-22.81424787,-1.004389343,-56.54476948,97031136.94,3218468.615,92,64,28,8.76,124.2366667,126.4833333,127.7466667,129.9933333,122.9733333,120.7266667,119.4633333,0.92022792,1249473386,198717877.5,-1
7/23/2015,126.2,127.09,125.06,125.16,50999452,AAPL,127.27,0.414265103,-1.88,-941.40625,-22.9908743,-0.943583658,-11.91967169,-45974875.45,982407.5209,88,60,28,2.03,125.77,126.48,127.8,128.51,124.45,123.74,122.42,0.049261084,1198473934,198693440.8,-1
7/24/2015,125.32,125.74,123.9,124.5,42162332,AAPL,127.392,0.41397019,1.16,-803.3333333,-24.93376509,-0.471027815,-35.41466988,-14665158.96,271154.4992,84,56,28,1.84,124.7133333,125.5266667,126.5533333,127.3666667,123.6866667,122.8733333,121.8466667,0.326086957,1156311602,198471108.2,-1
7/27/2015,123.09,123.61,122.12,122.77,44455540,AAPL,127.103,0.412345027,2.84,-412.6712329,-30.02649397,0.391541266,-79.42537635,-5668827.248,1155.32882,80,52,28,2.38,122.8333333,123.5466667,124.3233333,125.0366667,122.0566667,121.3433333,120.5666667,0.436241611,1111856062,197853372.6,-1
7/28/2015,123.38,123.91,122.55,123.38,33618097,AAPL,126.88,0.410941775,3.44,1562.962963,-28.23079188,0.801684738,-63.10404336,7415756.691,338182.6635,76,48,28,1.36,123.28,124.01,124.64,125.37,122.65,121.92,121.29,0.610294118,1145474159,198020408.9,1
7/29/2015,123.15,123.5,122.27,122.99,37011653,AAPL,126.497,0.409029424,5.52,433.5616438,-29.3788637,0.958756604,-71.21582292,6319062.707,610040.8473,72,44,28,1.23,122.92,123.57,124.15,124.8,122.34,121.69,121.11,0.585365854,1108462506,197903416.3,-1
7/30/2015,122.32,122.5699,121.71,122.37,33628268,AAPL,125.883,0.406382861,7.25,-1038.461538,-31.20400353,1.076477165,-90.82732735,17993215.61,1400185.155,68,40,28,1.28,122.2166333,122.7232667,123.0765333,123.5831667,121.8633667,121.3567333,121.0034667,0.767531108,1074834238,197733894.2,-1
7/31/2015,122.6,122.6425,120.91,121.3,42884953,AAPL,125.051,0.403046005,10.77,-162.1559633,-34.35384162,1.064568932,-101.7514949,-23577441.69,264838.48,64,36,28,1.7325,121.6175,122.325,123.35,124.0575,120.5925,119.885,118.86,0.225108225,1031949285,197358909.3,-1
8/3/2015,121.5,122.57,117.52,118.44,69975968,AAPL,123.688,0.398015637,12.31,-98.60529986,-42.77303503,0.683671241,-141.1593114,-44479773.72,-1769007.529,60,32,28,5.05,119.51,121.5,124.56,126.55,116.45,114.46,111.4,0.182178218,961973317,195709022.5,-1
8/4/2015,117.42,117.7,113.25,114.64,124138623,AAPL,122.077,0.392199034,10.58,-48.11165846,-53.95937592,-0.053247187,-211.4833531,-46586854.02,-3806182.37,56,96,-40,5.19,115.1966667,117.1433333,119.6466667,121.5933333,112.6933333,110.7466667,108.2433333,0.312359551,837834694,191726189.3,-1
8/5/2015,112.95,117.44,112.1,115.4,99312613,AAPL,121.095,0.388413255,9.76,-37.60488177,-51.72210774,-1.349768824,-170.6265994,23433313.18,-2568023.481,52,96,-44,5.34,114.98,117.86,120.32,123.2,112.52,109.64,107.18,0.617977528,937147307,192384577.1,1
8/6/2015,115.97,116.5,114.115,115.13,52903040,AAPL,120.092,0.384576616,9.37,-26.36300897,-52.5169267,-2.541049185,-140.403347,-7874456.688,-2809224.991,48,96,-48,2.385,115.2483333,116.3816667,117.6333333,118.7666667,113.9966667,112.8633333,111.6116667,0.42557652,884244267,192260800.5,-1
8/7/2015,114.58,116.25,114.5,115.52,38670405,AAPL,119.194,0.381092181,7.25,-10.63444109,-51.36885487,-2.98283288,-119.9727146,6408238.543,-2390249.375,44,92,-48,1.75,115.4233333,116.3466667,117.1733333,118.0966667,114.5966667,113.6733333,112.8466667,0.582857143,922914672,192391795.6,1
8/10/2015,116.53,119.99,116.53,119.72,54951597,AAPL,118.889,0.379521415,3.66,-54.0344515,-38.91509434,-3.3776725,-62.07572078,46375336.2,-173631.8494,40,88,-48,4.47,118.7466667,120.9633333,122.2066667,124.4233333,117.5033333,115.2866667,114.0433333,0.921965318,977866269,194389689.5,1
8/11/2015,117.81,118.18,113.33,113.49,97082814,AAPL,117.9,0.375764398,9.5,-50.80988917,-48.41580634,-3.917270145,-110.3073348,-90677349.98,-4287437.219,36,84,-48,6.39,115,116.67,119.85,121.52,111.82,110.15,106.97,0.032989691,880783455,189337685.4,-1
8/12/2015,112.53,115.42,109.63,115.24,101685610,AAPL,117.125,0.372708289,7.13,-77.72177419,-42.18583126,-4.254326587,-114.2389538,95363188.65,242136.6842,32,80,-48,5.79,113.43,117.23,119.22,123.02,111.44,107.64,105.65,0.968911917,982469065,190905663.3,1
8/13/2015,116.04,116.4,114.54,115.15,48535789,AAPL,116.403,0.369832251,6.15,-82.45989305,-39.60359013,-4.927418669,-70.87088094,-16700486.54,-527982.5532,28,96,-68,1.86,115.3633333,116.1866667,117.2233333,118.0466667,114.3266667,113.5033333,112.4666667,0.327956989,933933276,190867757.9,-1
8/14/2015,114.32,116.31,114.01,115.96,42929516,AAPL,115.869,0.367564205,2.48,-125.1101322,-31.91489362,-5.752946722,-58.27327898,29864011.13,853471.7052,24,92,-68,2.3,115.4266667,116.8433333,117.7266667,119.1433333,114.5433333,113.1266667,112.2433333,0.847826087,976862792,191169737.1,1
8/17/2015,116.04,117.65,115.5,117.16,40884745,AAPL,115.741,0.366586704,-2.52,-146.4630225,-27.09755118,-6.332702606,-33.11703878,22248907.74,1825991.525,20,88,-68,2.15,116.77,118.04,118.92,120.19,115.89,114.62,113.74,0.772093023,1017747537,191592828.7,1
8/18/2015,116.43,117.44,116.01,116.5,34560708,AAPL,115.927,0.366593897,-1.1,-140.3697997,-28.57142857,-6.688721282,-26.03594964,-10875747.27,1248639.762,16,84,-68,1.43,116.65,117.29,118.08,118.72,115.86,115.22,114.43,0.342657343,983186829,191398137.1,-1
8/19/2015,116.1,116.52,114.68,115.01,48286510,AAPL,115.888,0.3658885,0.12,-123.7771739,-32.282965,-6.72728746,-35.25036647,-30966348.8,-215677.9005,12,80,-68,1.84,115.4033333,116.1266667,117.2433333,117.9666667,114.2866667,113.5633333,112.4466667,0.179347826,934900319,190780567.1,-1
8/20/2015,114.08,114.35,111.63,112.65,68501622,AAPL,115.64,0.364520681,2.87,-105.3179191,-42.2649889,-6.228742029,-56.55564947,-17125405.5,-984301.8823,8,76,-68,3.38,112.8766667,114.1233333,115.5966667,116.8433333,111.4033333,110.1566667,108.6833333,0.375,866398697,189374916.9,-1
8/21/2015,110.43,111.9,105.645,105.76,128275471,AAPL,114.664,0.360852862,13.96,-71.84542587,-71.31947391,-5.889955929,-102.924366,-123558707.1,-6555865.755,4,72,-68,7.005,107.7683333,109.8916667,114.0233333,116.1466667,103.6366667,101.5133333,97.38166667,0.018385292,738123226,181529217.9,-1
8/24/2015,94.87,108.8,92,103.12,162206292,AAPL,113.004,0.355057628,10.37,-79.07986111,-60.27152554,-5.520622891,-155.5280065,52523942.17,-3870419.94,0,96,-96,16.8,101.3066667,110.6133333,118.1066667,127.4133333,93.81333333,84.50666667,77.01333333,0.661904762,575916934,177480195.5,-1
8/25/2015,111.11,111.11,103.5,103.74,103601599,AAPL,112.029,0.351422434,11.5,-76.9296741,-58.05644873,-5.052371688,-89.76401575,-97066938.35,-8106625.322,0,96,-96,7.99,106.1166667,108.7333333,113.7266667,116.3433333,101.1233333,98.50666667,93.51333333,0.031537451,679518533,178103091.1,1
8/26/2015,107.085,109.89,105.05,109.69,96774611,AAPL,111.474,0.349137028,5.46,-274.2647059,-36.79885673,-5.131831115,-61.49088552,88776709.26,-3702837.387,4,92,-88,6.15,108.21,111.37,113.05,116.21,106.53,103.37,101.69,0.958677686,776293144,183653591.7,1
8/27/2015,112.25,113.24,110.02,112.92,84616056,AAPL,111.251,0.347906729,3.04,-683.0769231,-25.25902108,-4.643148566,-18.38626648,67797957.91,-452801.2367,0,88,-88,3.55,112.06,114.1,115.28,117.32,110.88,108.84,107.66,0.900621118,860909200,186145248.7,1
8/28/2015,112.17,113.31,111.54,113.29,53164407,AAPL,110.984,0.346546908,3.87,-216.6407465,-23.9371204,-4.383658519,-7.645148025,51962951.47,1929732.977,0,84,-84,1.77,112.7133333,113.8866667,114.4833333,115.6566667,112.1166667,110.9433333,110.3466667,0.988700565,914073607,186319450.2,1
8/31/2015,112.13,114.53,112,112.76,56229271,AAPL,110.544,0.344655232,3.74,-1908.219178,-20.70282659,-4.173201624,0.083959257,-22447258.38,821687.9156,4,80,-76,2.53,113.0966667,114.1933333,115.6266667,116.7233333,111.6633333,110.5666667,109.1333333,0.300395257,857844336,186056395.1,-1
9/1/2015,110.18,111.88,107.36,107.72,76845860,AAPL,109.666,0.341395243,7.29,-161.9680851,-38.71345029,-4.329101828,-47.77141717,-64604926.55,-2152249.106,0,76,-76,5.4,108.9866667,110.6133333,113.5066667,115.1333333,106.0933333,104.4666667,101.5733333,0.079646018,780998476,182621638.7,-1
9/2/2015,110,112.34,109.131,112.34,61888812,AAPL,109.399,0.340054801,0.31,-597.8647687,-20.70175439,-4.546348898,-17.76024554,61888812,758708.2175,0,72,-72,4.62,111.2703333,113.4096667,114.4793333,116.6186667,110.2006667,108.0613333,106.9916667,1,842887288,185275986.2,1
9/3/2015,112.49,112.78,110.04,110.37,53233940,AAPL,109.171,0.338830241,-4.61,-286.0465116,-28.38206628,-4.795368727,-18.94513185,-40411166.13,-1112649.707,4,68,-64,2.74,111.0633333,112.0866667,113.8033333,114.8266667,109.3466667,108.3233333,106.6066667,0.120437956,789653348,184342473.1,-1
9/4/2015,108.97,110.45,108.51,109.27,49996311,AAPL,109.522,0.339384005,-6.15,-187.4524715,-32.6705653,-4.95456927,-40.66678244,-10823943.62,-1554072.158,0,64,-64,1.94,109.41,110.31,111.35,112.25,108.37,107.47,106.43,0.391752577,739657037,183844186,-1
9/8/2015,111.65,112.56,110.32,112.31,54843626,AAPL,110.441,0.341691256,-8.57,-425.5369928,-20.16509434,-4.812731316,-0.039716233,42601745.2,453010.449,0,60,-60,3.29,111.73,113.14,113.97,115.38,110.9,109.49,108.66,0.888392857,794500663,185369990.2,1
9/9/2015,113.76,114.02,109.77,110.15,85010804,AAPL,111.082,0.34312527,-0.46,-366.872428,-25.97879282,-3.933301485,-3.729982382,-69808871.99,-2740711.48,16,56,-40,4.25,111.3133333,112.8566667,115.5633333,117.1066667,108.6066667,107.0633333,104.3566667,0.089411765,709489859,183735021.5,-1
9/10/2015,110.27,113.2825,109.9,112.57,62892831,AAPL,111.37,0.343483908,0.35,-25312.5,-8.699511762,-2.790091696,7.427647689,36396959.85,-961726.4197,12,52,-40,3.3825,111.9175,113.935,115.3,117.3175,110.5525,108.535,107.17,0.789356984,772382690,185116779.5,1
9/11/2015,111.79,114.21,111.76,114.21,49915473,AAPL,111.499,0.343362381,-0.92,259.0532544,-1.420328451,-1.542375282,36.70734854,49915473,1350873.554,8,48,-40,2.45,113.3933333,115.0266667,115.8433333,117.4766667,112.5766667,110.9433333,110.1266667,1,822298163,185843983.7,1
9/14/2015,116.58,116.89,114.86,115.31,58363431,AAPL,111.701,0.343468347,-2.55,188.5972108,-6.347930896,-1.023855927,91.00529133,-32488018.24,-187257.8913,4,44,-40,2.68,115.6866667,116.5133333,117.7166667,118.5433333,114.4833333,113.6566667,112.4533333,0.221674877,880661594,186406104.2,1
9/15/2015,115.93,116.53,114.42,116.28,43341155,AAPL,112.053,0.344034183,-8.56,186.1244019,-3.409726104,-0.873840013,121.906568,33070739.12,1324469.246,0,40,-40,2.11,115.7433333,117.0666667,117.8533333,119.1766667,114.9566667,113.6333333,112.8466667,0.881516588,924002749,186770694.6,1
9/16/2015,116.25,116.54,115.44,116.41,37173489,AAPL,112.922,0.34616859,-4.07,260.7142857,-2.683063164,-0.499090813,154.2271061,28387027.96,2554585.551,0,36,-36,1.1,116.13,116.82,117.23,117.92,115.72,115.03,114.62,0.881818182,961176238,186812254.2,1
9/17/2015,115.66,116.49,113.715,113.92,64112641,AAPL,113.08,0.346122955,-3.55,1429,-16.60145333,-0.489725201,115.1108969,-54640142.69,-45174.82355,12,32,-20,2.775,114.7083333,115.7016667,117.4833333,118.4766667,112.9266667,111.9333333,110.1516667,0.073873874,897063597,185440890.3,-1
9/18/2015,112.21,114.3,111.87,113.45,74285291,AAPL,113.388,0.346529055,-4.18,8700,-19.22861934,0.339247776,60.64139557,22316157.38,971249.3675,8,28,-20,2.43,113.2066667,114.5433333,115.6366667,116.9733333,112.1133333,110.7766667,109.6833333,0.650205761,822778306,185134411.3,-1
9/21/2015,113.67,115.37,113.66,115.21,50221965,AAPL,113.982,0.347806037,-2.9,640,-9.390721073,0.616274542,94.45231336,40823702.54,2782724.512,4,24,-20,1.92,114.7466667,115.8333333,116.4566667,117.5433333,114.1233333,113.0366667,112.4133333,0.906432749,873000271,185913526.8,1
9/22/2015,113.38,114.18,112.5201,113.4,50346159,AAPL,114.091,0.347602757,-3.25,276.056338,-19.50810509,1.199925312,31.0226526,3030050.777,2793966.615,0,20,-20,2.6899,113.3667,114.2133,115.0266,115.8732,112.5534,111.7068,110.8935,0.530092174,822654112,185122566.4,-1
9/23/2015,113.63,114.72,113.3,114.32,35756716,AAPL,114.508,0.348332956,-1.75,605.0505051,-14.36556736,2.084594639,44.08266389,15612087.27,3376608.463,0,16,-16,1.42,114.1133333,114.9266667,115.5333333,116.3466667,113.5066667,112.6933333,112.0866667,0.718309859,858410828,185412656.2,1
9/24/2015,113.25,115.5,112.37,115,50219475,AAPL,114.751,0.348538099,-0.79,273.4341253,-10.56456121,2.578551616,40.07494094,34174914.3,4776531.455,68,12,56,3.13,114.29,116.21,117.42,119.34,113.08,111.16,109.95,0.840255591,908630303,185711372.4,1
9/25/2015,116.44,116.69,114.02,114.71,56151926,AAPL,114.801,0.34815974,0.6,232.7205882,-12.18557854,3.314842091,60.80565362,-27129582.22,3326253.561,64,8,56,2.67,115.14,116.26,117.81,118.93,113.59,112.47,110.92,0.258426966,852478377,185569771.9,-1
9/28/2015,113.85,114.57,112.44,112.44,52109011,AAPL,114.514,0.346759892,3.84,7400,-24.87423141,3.558364675,0.817607164,-52109011,806468.8078,60,4,56,2.27,113.15,113.86,115.28,115.99,111.73,111.02,109.6,0,800369366,184538585,-1
9/29/2015,112.83,113.51,107.86,109.06,73365384,AAPL,113.792,0.344045814,7.35,-882.5688073,-43.76746786,3.064394773,-86.1517948,-42201327.08,-1148431.005,56,0,56,5.65,110.1433333,112.4266667,115.7933333,118.0766667,106.7766667,104.4933333,101.1266667,0.212389381,727003982,182333186.6,-1
9/30/2015,110.17,111.54,108.73,110.3,66473033,AAPL,113.181,0.341681232,3.62,-371.8061674,-36.83622135,2.247125778,-79.80691747,7806441.598,-741391.3415,52,0,52,2.81,110.19,111.65,113,114.46,108.84,107.38,106.03,0.558718861,793477015,183088977.5,1
10/1/2015,109.07,109.62,107.31,109.58,63929100,AAPL,112.747,0.33985242,3.87,-146.8682505,-40.8608161,1.260785174,-106.6548232,61715105.19,2097540.319,48,0,48,2.99,108.8366667,110.3633333,111.1466667,112.6733333,108.0533333,106.5266667,105.7433333,0.982683983,729547915,182671670.6,-1
10/2/2015,108.01,111.0136,107.55,110.38,58019758,AAPL,112.44,0.338413822,4.83,-131.8458418,-36.38904416,0.583465549,-79.02561442,36792526.99,3674585.168,44,96,-52,3.4636,109.6478667,111.7457333,113.1114667,115.2093333,108.2821333,106.1842667,104.8185333,0.817068946,787567673,183095249.8,1
10/5/2015,109.88,111.3698,109.07,110.78,52064743,AAPL,111.997,0.336577399,2.62,-107.8181818,-33.40870548,0.419609251,-63.34673991,25359998.74,4660285.785,40,92,-52,2.2998,110.4066,111.7432,112.7064,114.043,109.4434,108.1068,107.1436,0.743542917,839632416,183283924.3,1
10/6/2015,110.63,111.74,109.765,111.31,48856977,AAPL,111.788,0.335447277,3.01,-124.1176471,-30.41266252,0.341113263,-51.49146527,27582546.51,5702206.727,36,88,-52,1.975,110.9383333,112.1116667,112.9133333,114.0866667,110.1366667,108.9633333,108.1616667,0.782278481,888489393,183517668.7,1
10/7/2015,111.74,111.77,109.41,110.78,46765550,AAPL,111.434,0.333888195,4.22,-201.5923567,-33.40870548,-0.048430636,-63.588665,7530046.186,5785290.339,32,84,-52,2.36,110.6533333,111.8966667,113.0133333,114.2566667,109.5366667,108.2933333,107.1766667,0.580508475,841723843,183294995.6,-1
10/8/2015,110.19,110.19,108.21,109.5,61979577,AAPL,110.884,0.331748027,5.21,-160.2531646,-40.64443188,-0.570058585,-103.5822308,18781690,6376035.778,28,80,-52,2.57,109.3,110.39,111.28,112.37,108.41,107.32,106.43,0.651515152,779744266,182578856.8,-1
10/9/2015,110,112.28,109.49,112.12,52766140,AAPL,110.625,0.330490606,0.32,-232.6860841,-25.83380441,-0.90148052,-37.54930005,46714109.61,8209584.588,24,76,-52,2.79,111.2966667,113.1033333,114.0866667,115.8933333,110.3133333,108.5066667,107.5233333,0.94265233,832510406,183841389.1,1
10/12/2015,112.73,112.75,111.44,111.6,30467204,AAPL,110.541,0.329753477,-2.54,-399.4444444,-28.77331826,-1.499439323,-14.43022293,-23024833.56,6789838.309,20,72,-52,1.31,111.93,112.42,113.24,113.73,111.11,110.62,109.8,0.122137405,802043202,183700085.6,-1
10/13/2015,110.82,112.45,110.68,111.79,33049256,AAPL,110.814,0.330074369,-1.49,-255.3359684,-27.69926512,-2.170900194,-17.43101621,8402353.22,6863134.441,16,68,-52,1.77,111.64,112.6,113.41,114.37,110.83,109.87,109.06,0.627118644,835092458,183756352.2,1
10/14/2015,111.29,111.52,109.56,110.21,44462449,AAPL,110.805,0.329554264,-0.63,-120.6680585,-36.6308649,-2.419237112,-48.15194888,-14972049.15,5870626.096,12,64,-52,2.23,110.43,111.3,112.39,113.26,109.34,108.47,107.38,0.331632653,790630009,183127935.8,-1
10/15/2015,110.93,112.1,110.49,111.86,37673452,AAPL,111.033,0.329741106,-1.48,-260.7017544,-27.30356133,-2.301827628,-8.507880421,26441615.38,6805671.063,8,60,-52,1.89,111.4833333,112.4766667,113.0933333,114.0866667,110.8666667,109.8733333,109.2566667,0.850931677,828303461,183691960.8,1
10/16/2015,111.78,112,110.53,111.04,39232609,AAPL,111.099,0.329446324,-0.26,-530.7142857,-22.67180475,-2.21128805,-15.72709098,-12009982.35,5950414.09,4,56,-52,1.47,111.19,111.85,112.66,113.32,110.38,109.72,108.91,0.346938776,789070852,183404362.6,-1
10/19/2015,110.8,111.75,110.11,111.73,29759153,AAPL,111.194,0.329240325,-0.42,304.1198502,-12.26740179,-1.888493285,-9.210316289,29033320,6999637.086,0,52,-52,1.64,111.1966667,112.2833333,112.8366667,113.9233333,110.6433333,109.5566667,109.0033333,0.987804878,818830005,183589285.3,1
10/20/2015,111.34,114.17,110.82,113.77,48967763,AAPL,111.44,0.329486251,-2.99,257.0605187,-2.636783125,-1.533211983,55.41281136,37273968.85,8375743.075,32,48,-16,3.35,112.92,115.02,116.27,118.37,111.67,109.57,108.32,0.880597015,867797768,184483353.5,1
10/21/2015,114,115.58,113.7,113.76,42326974,AAPL,111.738,0.329882584,-4.26,213.3971292,-10.97708082,-1.147716199,114.9020378,-39625252.26,6193879.651,28,44,-16,1.88,114.3466667,114.9933333,116.2266667,116.8733333,113.1133333,112.4666667,111.2333333,0.031914894,825470794,184479633.1,-1
10/22/2015,114.33,115.5,114.1,115.5,41654089,AAPL,112.338,0.331167035,-3.38,192.578125,-0.482509047,-0.759218858,148.2181228,41654089,7805707.349,24,40,-16,1.74,115.0333333,115.9666667,116.4333333,117.3666667,114.5666667,113.6333333,113.1666667,1,867124883,185116747.3,1
10/23/2015,116.7,119.228,116.33,119.08,59366914,AAPL,113.034,0.332740911,-7.48,157.1084337,-0.731659086,-0.332161091,270.7309317,53303212.64,9873775.771,20,36,-16,3.728,118.2126667,120.0953333,121.1106667,122.9933333,117.1973333,115.3146667,114.2993333,0.948930297,926491797,186956864.6,1
10/26/2015,118.08,118.13,114.92,115.28,66333781,AAPL,113.402,0.333334432,-3.49,315.1133501,-19.51750049,0.193991378,150.7541199,-51455175.92,7086096.149,96,32,64,4.16,116.11,117.3,119.32,120.51,114.09,112.9,110.88,0.112149533,860158016,184840066.1,-1
10/27/2015,115.4,116.54,113.99,114.55,69884400,AAPL,113.678,0.333653648,-4.34,331.8302387,-23.1263595,0.486940199,95.76905543,-39190075.29,4982633.811,92,28,64,2.55,115.0266667,116.0633333,117.5766667,118.6133333,113.5133333,112.4766667,110.9633333,0.219607843,790273616,184397529.6,-1
10/28/2015,116.93,119.3,116.06,119.27,85551352,AAPL,114.584,0.335822395,-7.41,176.3561924,-0.147783251,0.882974487,179.9013407,83967067.7,8572835.351,88,24,64,4.75,118.21,120.36,121.45,123.6,117.12,114.97,113.88,0.990740741,875824968,187922648.6,1
10/29/2015,118.7,120.69,118.27,120.53,51227334,AAPL,115.451,0.337873101,-9.49,188.7039239,-0.737667128,1.384761248,197.566632,44453471.65,10203773.37,96,20,76,2.42,119.83,121.39,122.25,123.81,118.97,117.41,116.55,0.933884298,927052302,188463827.7,1
10/30/2015,120.99,121.22,119.45,119.5,49365254,AAPL,116.297,0.339848821,-7.77,200.8860759,-7.740774077,2.180286783,161.357346,-46576256.6,7622862.912,96,16,80,1.77,120.0566667,120.6633333,121.8266667,122.4333333,118.8933333,118.2866667,117.1233333,0.028248588,877687048,188041972.5,-1
11/2/2015,119.87,121.36,119.61,121.18,32203267,AAPL,117.242,0.342108875,-7.41,184.8775293,-0.805008945,2.839937193,142.1039733,25578594.93,8439032.549,96,12,84,1.86,120.7166667,121.8233333,122.4666667,123.5733333,120.0733333,118.9666667,118.3233333,0.897142857,909890315,188494704.6,1
11/3/2015,120.79,123.49,120.7,122.57,45518976,AAPL,118.122,0.344176381,-8.81,151.6990291,-3.756635361,3.575306174,142.7794173,15499292.9,8759953.475,96,8,88,2.79,122.2533333,123.8066667,125.0433333,126.5966667,121.0166667,119.4633333,118.2266667,0.670250896,955409291,189016831.8,1
11/4/2015,123.13,123.82,121.62,122,44886050,AAPL,118.946,0.34607011,-6.5,168.6390533,-7.332796132,4.066105527,121.0364773,-29379960,7026321.044,96,4,92,2.2,122.48,123.34,124.68,125.54,121.14,120.28,118.94,0.172727273,910523241,188808093.6,-1
11/5/2015,121.85,122.69,120.18,120.92,39552680,AAPL,119.488,0.347137639,-1.84,173.0769231,-11.68412571,4.385453687,80.82767792,-16230781.04,5969180.04,96,0,96,2.51,121.2633333,122.3466667,123.7733333,124.8566667,119.8366667,118.7533333,117.3266667,0.294820717,870970561,188457955.1,-1
11/6/2015,121.11,121.81,120.62,121.06,33042283,AAPL,119.686,0.347210484,-5.78,177.3847803,-11.12006446,4.71401582,66.77620936,-8607653.555,5306596.695,92,0,92,1.19,121.1633333,121.7066667,122.3533333,122.8966667,120.5166667,119.9733333,119.3266667,0.369747899,904012844,188496211.1,1
11/9/2015,120.96,121.81,120.05,120.57,33871405,AAPL,120.215,0.34823135,-6.02,213.3823529,-13.09427881,4.884976522,52.34717848,-13856483.86,4435547.579,88,12,76,1.76,120.81,121.57,122.57,123.33,119.81,119.05,118.05,0.295454545,870141439,188359113.9,-1
11/10/2015,116.9,118.07,116.061,116.77,59127931,AAPL,120.437,0.348350256,2.5,482.0598007,-28.40451249,4.506494506,-0.222122459,-17394030.47,3443294.031,84,8,76,4.509,116.967,117.873,118.976,119.882,115.864,114.958,113.855,0.352911896,811013508,186495581.2,-1
11/11/2015,116.37,117.42,115.21,116.11,45217971,AAPL,120.121,0.34692368,4.42,2093.442623,-31.06365834,4.668045774,-13.21388582,-8388854.348,2905469.105,80,4,76,2.21,116.2466667,117.2833333,118.4566667,119.4933333,115.0733333,114.0366667,112.8633333,0.407239819,765795537,186240003.1,-1
11/12/2015,116.26,116.82,115.65,115.72,32525579,AAPL,119.64,0.345028849,3.78,-273.5119048,-32.6349718,4.919129951,-19.17016266,-28633629.38,1471873.719,76,0,76,1.17,116.0633333,116.4766667,117.2333333,117.6466667,115.3066667,114.8933333,114.1366667,0.05982906,733269958,186130753.4,-1
11/13/2015,115.2,115.57,112.27,112.34,45812403,AAPL,118.924,0.342456044,8.84,-312.585034,-46.25302176,4.364549206,-60.56521081,-43868846.51,-589068.1095,72,0,72,3.45,113.3933333,114.5166667,116.6933333,117.8166667,111.2166667,110.0933333,107.9166667,0.021212121,687457555,184792644.9,-1
11/16/2015,111.38,114.24,111,114.175,38106701,AAPL,118.2235,0.339945464,8.395,-2940,-38.85979049,3.805245911,-65.71032773,36577728.43,1100331.733,68,8,60,3.24,113.1383333,115.2766667,116.3783333,118.5166667,112.0366667,109.8983333,108.7966667,0.979938272,725564256,185415092.8,1
11/17/2015,114.92,115.05,113.32,113.69,27616939,AAPL,117.3355,0.336908817,8.31,-112.9928315,-40.81385979,3.304706684,-52.55035255,-15803913.07,331956.9694,64,4,60,1.73,114.02,114.72,115.75,116.45,112.99,112.29,111.26,0.213872832,697947317,185297779.7,-1
11/18/2015,115.76,117.49,115.5,117.29,46674697,AAPL,116.8645,0.33508567,3.63,-266.8209877,-26.30942788,2.632076737,-16.31149118,37292848.36,2011997.487,60,0,60,3.8,116.76,118.02,118.75,120.01,116.03,114.77,114.04,0.899497487,744622014,186775736.5,1
11/19/2015,117.64,119.75,116.76,118.78,43295820,AAPL,116.6505,0.33400586,2.28,-1407.638889,-20.30620467,1.650491648,5.910028355,15204217.73,2611643.862,56,8,48,2.99,118.43,120.1,121.42,123.09,117.11,115.44,114.12,0.675585284,787917834,187325747.4,1
11/20/2015,119.2,119.92,118.85,119.3,34287096,AAPL,116.4745,0.333039906,1.27,-477.393617,-18.21112006,0.798121885,22.01852058,-5447482.542,2245319.934,52,4,48,1.14,119.3566667,119.8633333,120.4266667,120.9333333,118.7933333,118.2866667,117.7233333,0.420560748,822204930,187475850.9,1
11/23/2015,119.27,119.73,117.34,117.75,32482528,AAPL,116.1925,0.331770782,-0.98,-157.3651452,-24.4560838,-0.05309941,0.996744617,-21337894.96,1173355.621,48,0,48,2.39,118.2733333,119.2066667,120.6633333,121.5966667,116.8166667,115.8833333,114.4266667,0.171548117,789722402,187053823,-1
11/24/2015,117.33,119.35,117.12,118.88,42803172,AAPL,116.4035,0.331905586,-2.77,-279.3269231,-19.90330379,-0.911645057,1.318090907,24760579.32,2245502.152,44,0,44,2.23,118.45,119.78,120.68,122.01,117.55,116.22,115.32,0.789237668,832525574,187464588.1,1
11/25/2015,119.21,119.23,117.92,118.03,21388308,AAPL,116.5955,0.33198201,-2.31,-301.5570934,-19.67074715,-1.653993888,-0.286662695,-17796378.41,1334507.581,40,72,-32,1.31,118.3933333,118.8666667,119.7033333,120.1766667,117.5566667,117.0833333,116.2466667,0.083969466,811137266,187311660.3,-1
11/27/2015,118.29,118.41,117.6,117.81,13046445,AAPL,116.8045,0.332104498,-5.47,-263.8461538,-17.53616835,-1.91504277,-12.8094336,-6281621.667,988319.8881,36,68,-32,0.81,117.94,118.28,118.75,119.09,117.47,117.13,116.66,0.259259259,798090821,187287342.6,-1
11/30/2015,117.99,119.41,117.75,118.3,39180322,AAPL,117.4005,0.333317887,-4.125,-399.339207,-15.38798772,-1.969847992,10.70747295,-13217458.02,342602.7103,32,64,-32,1.66,118.4866667,119.2233333,120.1466667,120.8833333,117.5633333,116.8266667,115.9033333,0.331325301,837271143,187450302.9,1
12/1/2015,118.75,118.81,116.86,117.34,34852374,AAPL,117.717,0.333735396,-3.65,1590.350877,-12.33269598,-1.763586516,-20.56426543,-17694282.18,-477255.694,28,60,-32,1.95,117.67,118.48,119.62,120.43,116.53,115.72,114.58,0.246153846,802418769,187167477.2,-1
12/2/2015,117.05,118.11,116.08,116.28,33386563,AAPL,117.976,0.333984707,1.01,5332.352941,-17.39961759,-1.324410946,-48.53663461,-26807929.9,-1674104.521,24,56,-32,2.03,116.8233333,117.5666667,118.8533333,119.5966667,115.5366667,114.7933333,113.5066667,0.098522167,769032206,186865877.1,-1
12/3/2015,116.55,116.79,114.22,115.2,41569509,AAPL,117.767,0.332915254,3.58,-1743.269231,-22.56214149,-1.17264624,-101.4214095,-9866692.798,-2046494.898,20,52,-32,2.57,115.4033333,116.5866667,117.9733333,119.1566667,114.0166667,112.8333333,111.4466667,0.381322957,727462697,186479782.6,-1
12/4/2015,115.29,119.25,115.11,119.03,57776977,AAPL,117.792,0.332520402,0.27,192.7503737,-4.254302103,-0.530831261,24.80742277,51636428.72,393637.9941,16,48,-32,4.14,117.7966667,120.4833333,121.9366667,124.6233333,116.3433333,113.6566667,112.2033333,0.946859903,785239674,188400666.5,1
12/7/2015,118.98,119.86,117.81,118.28,32084249,AAPL,117.69,0.331768331,-0.53,269.4275274,-7.839388145,-0.285608619,88.60823205,-17372447.02,-413911.3247,12,44,-32,2.05,118.65,119.49,120.7,121.54,117.44,116.6,115.39,0.229268293,753155425,188198505.8,-1
12/8/2015,117.52,118.6,116.86,118.23,34309450,AAPL,117.738,0.331437556,0.65,243.6123348,-8.078393881,-0.304120756,65.39285943,19718074.71,501178.9497,8,40,-32,1.74,117.8966667,118.9333333,119.6366667,120.6733333,117.1933333,116.1566667,115.4533333,0.787356322,718845975,188184002.3,-1
12/9/2015,117.64,117.69,115.08,115.62,46361357,AAPL,117.412,0.330053979,2.41,-446.7065868,-20.55449331,-0.364341767,-79.41386325,-27177347.21,-756935.8756,4,36,-32,3.15,116.13,117.18,118.74,119.79,114.57,113.52,111.96,0.206896552,672484618,187160546.8,-1
12/10/2015,116.04,116.94,115.51,116.17,29212727,AAPL,117.226,0.329067709,1.64,-249.8084291,-17.92543021,-0.119376074,-74.1424407,-2247132.846,-824672.1015,0,32,-32,1.43,116.2066667,116.9033333,117.6366667,118.3333333,115.4733333,114.7766667,114.0433333,0.461538462,701697345,187299510.6,1
12/11/2015,115.19,115.39,112.851,113.18,46886161,AAPL,116.763,0.327302677,5.12,-98.03921569,-32.21797323,-0.144034432,-286.4335263,-34735277.21,-2366063.243,0,28,-28,3.319,113.807,114.763,116.346,117.302,112.224,111.268,109.685,0.129578574,654811184,186092748,-1
12/14/2015,112.18,112.68,109.79,112.48,65003609,AAPL,116.181,0.325211124,4.86,-113.8519924,-35.37871524,-0.155668066,-407.1967241,56006569.69,287238.2542,0,24,-24,3.39,111.65,113.51,114.54,116.4,110.62,108.76,107.73,0.930795848,589807575,185690711.1,-1
12/15/2015,111.94,112.8,110.35,110.49,53323105,AAPL,115.496,0.322834214,5.79,-58.04529201,-44.91850431,-0.197599374,-303.2868586,-47229035.86,-1872592.387,0,96,-96,2.45,111.2133333,112.0766667,113.6633333,114.5266667,109.6266667,108.7633333,107.1766667,0.057142857,536484470,184747316.9,-1
12/16/2015,111.07,111.99,108.8,111.34,56238467,AAPL,115.002,0.320999023,3.86,-85.50074738,-40.84372004,-0.344509445,-243.6943817,33319969.48,-272930.4844,32,92,-60,3.19,110.71,112.62,113.9,115.81,109.43,107.52,106.24,0.796238245,592722937,185179959.7,1
12/17/2015,112.02,112.25,108.98,108.98,44772827,AAPL,114.38,0.318807631,10.05,-64.77916195,-52.15723873,-0.688609596,-203.5034481,-44772827,-2295653.053,28,96,-68,3.27,110.07,111.16,113.34,114.43,107.89,106.8,104.62,0,547950110,184230939.8,-1
12/18/2015,108.91,109.52,105.81,106.03,96453327,AAPL,113.08,0.314740448,12.25,-42.62428688,-66.2991371,-1.042011885,-234.9508272,-85014118.41,-6055583.297,24,92,-68,3.71,107.12,108.43,110.83,112.14,104.72,103.41,101.01,0.059299191,451496783,181620026.7,-1
12/21/2015,107.28,107.37,105.57,107.33,47590610,AAPL,111.985,0.311260148,10.9,-65.23476523,-60.06711409,-1.277668385,-182.9114496,45475471.78,-3713262.611,20,96,-76,1.8,106.7566667,107.9433333,108.5566667,109.7433333,106.1433333,104.9566667,104.3433333,0.977777778,499087393,182203520,1
12/22/2015,107.4,107.72,106.451,107.23,32789367,AAPL,110.885,0.307779573,8.39,-72.15469613,-60.54650048,-2.310498506,-136.6643754,7467397.213,-3205050.801,16,96,-80,1.269,107.1336667,107.8163333,108.4026667,109.0853333,106.5473333,105.8646667,105.2783333,0.613869188,466298026,182172969.9,-1
12/23/2015,107.27,108.85,107.2,108.61,32657354,AAPL,110.184,0.305415813,7.56,-120.030349,-53.93096836,-3.181543223,-94.68357207,23157032.84,-2006774.272,12,92,-80,1.65,108.22,109.24,109.87,110.89,107.59,106.57,105.94,0.854545455,498955380,182593254.8,1
12/24/2015,109,109,107.95,108.03,13596680,AAPL,109.37,0.302748611,5.15,-37.09090909,-56.7114094,-4.177362751,-79.37300132,-11524804.95,-2439412.03,8,88,-80,1.05,108.3266667,108.7033333,109.3766667,109.7533333,107.6533333,107.2766667,106.6033333,0.076190476,485358700,182520645.7,-1
12/28/2015,107.59,107.69,106.1807,106.82,26704210,AAPL,108.734,0.300575572,5.66,-35.60209424,-62.51198466,-4.700564104,-86.49616552,-4081800.336,-2514066.044,4,84,-80,1.8493,106.8969,107.6131,108.4062,109.1224,106.1038,105.3876,104.5945,0.423573842,458654490,182221542.7,-1
12/29/2015,106.96,109.43,106.86,108.74,30931243,AAPL,108.36,0.29913607,1.75,-63.22444679,-50.30612245,-5.225292934,-54.33408413,14322248.7,-1748779.01,0,80,-80,2.61,108.3433333,109.8266667,110.9133333,112.3966667,107.2566667,105.7733333,104.6866667,0.73151751,489585733,182777505.9,1
12/30/2015,108.58,108.7,107.18,107.32,25213777,AAPL,108.043,0.297852481,4.02,-72.28915663,-55.48421616,-5.395337187,-53.45212092,-20569133.87,-2604249.686,36,76,-40,1.56,107.7333333,108.2866667,109.2533333,109.8066667,106.7666667,106.2133333,105.2466667,0.092105263,464371956,182448247.5,-1
1/4/2016,102.61,105.368,102,105.35,67649387,AAPL,107.072,0.294365829,0.68,-70.75351213,-61.25686394,-5.606471446,-75.83459245,66926293.79,-399061.7104,28,96,-68,3.368,104.2393333,106.4786667,107.6073333,109.8466667,103.1106667,100.8713333,99.74266667,0.994655582,491109027,181720780.3,1
7/5/2016,95.39,95.4,94.46,94.99,27705210,AAPL,94.747,0.222026941,0.92,-227.5303644,-49.96415771,-2.434675785,-39.01666834,3536835.319,1037997.065,20,80,-60,1.43,94.95,95.44,95.89,96.38,94.5,94.01,93.56,0.563829787,295673218,163554755.7,-1
7/8/2016,96.49,96.89,96.05,96.68,28912103,AAPL,94.806,0.221396873,-3.28,511.1111111,-3.896103896,-1.974582154,24.15430206,14456051.5,2285848.408,8,68,-60,0.95,96.54,97.03,97.38,97.87,96.19,95.7,95.35,0.75,380673969,164061594,1
7/11/2016,96.75,97.65,96.73,96.98,23794945,AAPL,95.164,0.221974227,-4.94,382.9787234,-10.89430894,-1.920755208,46.5371502,-10862909.67,1688177.586,4,64,-60,0.97,97.12,97.51,98.04,98.43,96.59,96.2,95.67,0.27173913,404468914,164135430.2,1
7/12/2016,97.17,97.7,97.12,97.42,24167463,AAPL,95.702,0.222967119,-3.83,452.3178808,-4.516129032,-1.919579264,58.79682201,833360.7931,1649322.278,0,60,-60,0.72,97.41333333,97.70666667,97.99333333,98.28666667,97.12666667,96.83333333,96.54666667,0.517241379,428636377,164245078.4,1
7/13/2016,97.41,97.67,96.84,96.87,25892171,AAPL,96.03,0.223469214,-2.47,517.4242424,-13.38709677,-1.503964133,51.43391844,-24020447.8,482514.5471,8,56,-48,0.83,97.12666667,97.41333333,97.95666667,98.24333333,96.58333333,96.29666667,95.75333333,0.036144578,402744206,164098900,-1
7/14/2016,97.39,98.99,97.32,98.79,38918997,AAPL,96.469,0.224230797,-3.19,304.8327138,-2.670226969,-0.785507025,93.93061031,29597081.55,1805903.956,4,52,-48,2.12,98.36666667,99.41333333,100.0366667,101.0833333,97.74333333,96.69666667,96.07333333,0.880239521,441663203,164870289.3,1
7/15/2016,98.92,99.3,98.5,98.78,30136990,AAPL,96.787,0.22471028,-2.89,152.4163569,-6.666666667,-0.232498907,105.2984659,-9041097,1312858.458,0,48,-48,0.8,98.86,99.22,99.66,100.02,98.42,98.06,97.62,0.35,411526213,164867238.6,-1
7/18/2016,98.7,100.13,98.6,99.83,36493867,AAPL,97.181,0.225365731,-4.84,118.7419769,-3.476245655,0.3232994,125.2645781,22182546.61,2261480.647,0,44,-44,1.53,99.52,100.44,101.05,101.97,98.91,97.99,97.38,0.803921569,448020080,165255156.8,1
7/19/2016,99.56,100,99.34,99.87,23779924,AAPL,97.669,0.226235045,-4.34,123.2484076,-3.254067584,0.702205888,132.5366584,14412075.15,2813780.397,96,40,56,0.66,99.73666667,100.1333333,100.3966667,100.7933333,99.47333333,99.07666667,98.81333333,0.803030303,471800004,165264685,1
7/20/2016,100,100.46,99.735,99.96,26275968,AAPL,98.112,0.226997834,-4.02,126.2589928,-7.320644217,0.979369239,136.7964171,-9966746.483,2232847.357,92,36,56,0.725,100.0516667,100.3683333,100.7766667,101.0933333,99.64333333,99.32666667,98.91833333,0.310344828,498075972,165288364.2,1
7/21/2016,99.83,101,99.13,99.43,32702028,AAPL,98.461,0.22754042,-2.75,151.9582245,-23.43283582,1.406292415,116.5163046,-22209398.7,1121836.173,96,32,64,1.87,99.85333333,100.5766667,101.7233333,102.4466667,98.70666667,97.98333333,96.83666667,0.160427807,465373944,165114974.1,-1
7/22/2016,99.26,99.3,98.31,98.66,28313669,AAPL,98.659,0.227732447,-1.68,199.6389892,-35.29411765,1.755858607,67.79810812,-8293903.04,693848.0269,96,28,68,1.12,98.75666667,99.20333333,99.74666667,100.1933333,98.21333333,97.76666667,97.22333333,0.353535354,437060275,164895709,-1
7/25/2016,98.25,98.84,96.92,97.34,40382921,AAPL,98.695,0.22754887,0.08,235.3191489,-55.20361991,2.071352017,25.11318081,-22715393.06,-370208.3862,92,24,68,1.92,97.7,98.48,99.62,100.4,96.56,95.78,94.64,0.21875,396677354,164355414.5,-1
7/26/2016,96.82,97.97,96.42,96.67,56239822,AAPL,98.62,0.22710985,0.2,437.7192982,-65.3092006,2.149994861,-3.57347672,-38097943.94,-2085105.457,88,20,68,1.55,97.02,97.62,98.57,99.17,96.07,95.47,94.52,0.161290323,340437532,163968310.7,-1
7/27/2016,104.265,104.35,102.75,102.95,92344820,AAPL,99.228,0.228249801,-4.16,154.9215407,-16.03665521,2.344086091,184.7060792,-69258615,-5138446.8,84,16,68,7.68,103.35,103.95,104.95,105.55,102.35,101.75,100.75,0.125,432782352,169967332.9,1
7/28/2016,102.83,104.45,102.82,104.34,39869839,AAPL,99.783,0.229268191,-5.56,150.2610966,-1.30952381,2.592434382,155.831747,34488633.74,-3337215.866,96,12,84,1.63,103.87,104.92,105.5,106.55,103.29,102.24,101.66,0.932515337,472652191,170505643.5,1
7/29/2016,104.19,104.55,103.68,104.21,27733688,AAPL,100.326,0.230255059,-4.38,155.0484094,-4.18204182,2.928356119,132.257787,6056782.437,-2910215.943,96,8,88,0.87,104.1466667,104.6133333,105.0166667,105.4833333,103.7433333,103.2766667,102.8733333,0.609195402,444918503,170471089.3,-1
8/1/2016,104.41,106.15,104.41,106.05,38167871,AAPL,100.948,0.23142302,-6.18,146.1181924,-1.027749229,3.116071003,139.2972533,33780759.39,-1242444.337,96,4,92,1.94,105.5366667,106.6633333,107.2766667,108.4033333,104.9233333,103.7966667,103.1833333,0.942528736,483086374,171145006.2,1
8/2/2016,106.05,106.07,104,104.48,33816556,AAPL,101.409,0.23221622,-4.52,165.7030223,-17.16341213,3.125704564,102.797101,-18133515.54,-2010220.301,96,0,96,2.07,104.85,105.7,106.92,107.77,103.63,102.78,101.56,0.231884058,449269818,170644374.5,-1
8/3/2016,104.81,105.84,104.77,105.79,30202641,AAPL,101.992,0.233287091,-6.36,171.4285714,-3.699897225,2.955285326,97.17053271,27379964.27,-674302.8202,92,0,92,1.36,105.4666667,106.1633333,106.5366667,107.2333333,105.0933333,104.3966667,104.0233333,0.953271028,479472459,171023063.8,1
8/4/2016,105.58,106,105.28,105.87,27408650,AAPL,102.636,0.234492672,-7.21,170.3808181,-2.877697842,2.891466391,88.38613879,17511081.94,152305.5782,88,0,88,0.72,105.7166667,106.1533333,106.4366667,106.8733333,105.4333333,104.9966667,104.7133333,0.819444444,506881109,171043790.7,1
8/5/2016,106.27,107.65,106.18,107.48,40553402,AAPL,103.518,0.236237693,-10.14,165.2287582,-1.513802315,2.925982773,99.36604711,31173703.58,1562369.124,84,0,84,1.78,107.1033333,108.0266667,108.5733333,109.4966667,106.5566667,105.6333333,105.0866667,0.884353741,547434511,171660499.6,1
8/8/2016,107.52,108.37,107.16,108.37,28037220,AAPL,104.621,0.238479316,-11.7,158.7058824,0,3.163242066,100.3652394,28037220,2765771.436,96,8,88,1.21,107.9666667,108.7733333,109.1766667,109.9833333,107.5633333,106.7566667,106.3533333,1,575471731,171892664.9,1
8/9/2016,108.23,108.94,108.01,108.81,26315204,AAPL,105.835,0.24096525,-5.86,156.3841808,-1.038338658,3.585842971,96.8476815,18958265.25,3501793.882,96,4,92,0.93,108.5866667,109.1633333,109.5166667,110.0933333,108.2333333,107.6566667,107.3033333,0.860215054,601786935,171999509,1
8/10/2016,108.71,108.9,107.76,108,24008505,AAPL,106.34,0.24183807,-3.66,161.4935823,-7.50798722,4.183310979,79.44646366,-13899660.79,2710818.67,96,0,96,1.14,108.22,108.68,109.36,109.82,107.54,107.08,106.4,0.210526316,577778430,171820785.6,-1
8/11/2016,108.52,108.93,107.85,107.93,27484506,AAPL,106.699,0.242377858,-3.72,149.2988134,-8.067092652,4.992198339,70.17379721,-23412727.33,1523384.761,92,0,92,1.08,108.2366667,108.6233333,109.3166667,109.7033333,107.5433333,107.1566667,106.4633333,0.074074074,550293924,171802971.6,-1
8/12/2016,107.78,108.44,107.78,108.18,18660434,AAPL,107.096,0.243001824,-2.13,129.9815498,-6.07028754,5.035826756,59.60244432,3958273.879,1634061.539,88,0,88,0.66,108.1333333,108.4866667,108.7933333,109.1466667,107.8266667,107.4733333,107.1666667,0.606060606,568954358,171846195.1,1
8/15/2016,108.14,109.54,108.08,109.48,25868209,AAPL,107.439,0.243505082,-5,120.1405152,-0.457317073,4.990027034,62.05383809,23742054.84,2638970.325,84,44,40,1.46,109.0333333,109.9866667,110.4933333,111.4466667,108.5266667,107.5733333,107.0666667,0.95890411,594822567,172157053.5,1
8/16/2016,109.63,110.23,109.21,109.38,33794448,AAPL,107.929,0.244336766,-3.59,141.6796267,-7.569011576,5.000255235,59.22566708,-22529632,1494942.947,96,40,56,1.02,109.6066667,110.0033333,110.6266667,111.0233333,108.9833333,108.5866667,107.9633333,0.166666667,561028119,172126185.4,-1
8/17/2016,109.1,109.37,108.34,109.22,25355976,AAPL,108.272,0.244834577,-3.35,158.1967213,-8.993766696,4.796699603,46.79513615,17970740.27,2243842.825,96,36,60,1.04,108.9766667,109.6133333,110.0066667,110.6433333,108.5833333,107.9466667,107.5533333,0.854368932,535672143,172089094.9,-1
8/18/2016,109.23,109.6,109.02,109.08,21984703,AAPL,108.593,0.245280651,-1.6,158.5215606,-10.24042743,4.785050399,45.32691323,-17436143.76,1349297.98,92,32,60,0.58,109.2333333,109.4466667,109.8133333,110.0266667,108.8666667,108.6533333,108.2866667,0.103448276,513687440,172060914.6,-1
8/19/2016,108.77,109.69,108.36,109.36,25368072,AAPL,108.781,0.245427418,-0.99,186.102719,-7.747105966,4.740322964,38.68103457,12779404.69,1868848.285,88,28,60,1.33,109.1366667,109.9133333,110.4666667,111.2433333,108.5833333,107.8066667,107.2533333,0.751879699,539055512,172126032.5,1
8/22/2016,108.86,109.1,107.85,108.51,25820230,AAPL,108.795,0.245181525,0.3,152.853598,-15.31611754,4.679495784,24.71642014,1445932.88,1849624.858,84,24,60,1.51,108.4866667,109.1233333,109.7366667,110.3733333,107.8733333,107.2366667,106.6233333,0.528,513235282,171925344.9,-1
8/23/2016,108.59,109.32,108.53,108.85,21257669,AAPL,108.799,0.244914644,-0.85,169.6078431,-12.28851291,4.479329003,23.46189084,-4036266.266,1582084.352,80,20,60,0.81,108.9,109.27,109.69,110.06,108.48,108.11,107.69,0.405063291,534492951,171991952.6,1
8/24/2016,108.565,108.75,107.68,108.03,23675081,AAPL,108.802,0.244644042,-0.1,236.5740741,-19.5903829,4.133742553,10.18689451,-8186710.252,1138048.234,76,16,60,1.17,108.1533333,108.6266667,109.2233333,109.6966667,107.5566667,107.0833333,106.4866667,0.327102804,510817870,171813601.1,-1
8/25/2016,107.39,107.88,106.68,107.57,25086248,AAPL,108.766,0.244285832,0.61,3888.888889,-23.68655387,3.705517402,-4.268398417,12125019.87,1637456.035,72,12,60,1.35,107.3766667,108.0733333,108.5766667,109.2733333,106.8733333,106.1766667,105.6733333,0.741666667,485731622,171706781.9,-1
8/26/2016,107.41,107.95,106.31,106.94,27766291,AAPL,108.642,0.243730727,2.54,-182.5174825,-29.29652716,3.32232757,-12.83487812,-6433652.793,1270587.452,68,8,60,1.64,107.0666667,107.8233333,108.7066667,109.4633333,106.1833333,105.4266667,104.5433333,0.384146341,457965331,171544164.4,-1
8/29/2016,106.62,107.44,106.29,106.82,24970300,AAPL,108.376,0.242860629,2.56,-109.0452261,-30.3650935,2.882281927,-19.98813781,-1954197.391,1124006.323,64,4,60,1.15,106.85,107.41,108,108.56,106.26,105.7,105.11,0.460869565,432995031,171516144.6,-1
8/30/2016,105.8,106.5,105.5,106,24863945,AAPL,108.038,0.241830916,3.22,-108.5,-37.66696349,2.284679449,-42.9857216,0,1072915.126,60,0,60,1.32,106,106.5,107,107.5,105.5,105,104.5,0.5,408131086,171325277.4,-1
8/31/2016,105.66,106.5699,105.64,106.1,29662406,AAPL,107.726,0.240862381,2.98,-124.0437158,-36.77649154,1.433383365,-45.27571059,-315795.0526,1009791.936,56,0,56,0.9299,106.1033,106.5666,107.0332,107.4965,105.6367,105.1734,104.7068,0.494676847,437793492,171353260.8,1
9/1/2016,106.14,106.8,105.62,106.73,26701523,AAPL,107.491,0.240069281,2.63,-182.7586207,-31.16651825,0.960874721,-42.77999538,23533545.69,2033598.925,52,0,52,1.18,106.3833333,107.1466667,107.5633333,108.3266667,105.9666667,105.2033333,104.7866667,0.940677966,464495015,171511809,1
9/2/2016,107.7,108,106.82,107.73,26802450,AAPL,107.328,0.239440669,0.78,-134.2857143,-22.26179875,0.593249156,-14.07684964,14536922.03,2601931.794,48,0,48,1.27,107.5166667,108.2133333,108.6966667,109.3933333,107.0333333,106.3366667,105.8533333,0.771186441,491297465,171762932.9,1
9/6/2016,107.9,108.3,107.51,107.7,26880391,AAPL,107.247,0.238995396,1.15,-139.8809524,-22.52894034,0.212063115,-5.256500013,-13950582.67,1849544.773,44,4,40,0.79,107.8366667,108.1633333,108.6266667,108.9533333,107.3733333,107.0466667,106.5833333,0.240506329,464417074,171755447.4,-1
9/7/2016,107.83,108.76,107.07,108.36,42364328,AAPL,107.198,0.238623744,-0.33,-350,-12.44153414,-0.101161141,4.005228775,22310208.24,2779574.93,40,0,40,1.69,108.0633333,109.0566667,109.7533333,110.7466667,107.3666667,106.3733333,105.6766667,0.763313609,506781402,172015061.6,1
9/8/2016,107.25,107.27,105.24,105.52,53002026,AAPL,106.947,0.237799601,2.05,-84.5505618,-39.00841908,-0.488716928,-90.70160795,-38380777.45,908649.8223,36,0,36,3.12,106.01,106.78,108.04,108.81,104.75,103.98,102.72,0.137931034,453779376,170625935.1,-1
9/9/2016,104.64,105.72,103.13,103.13,46556984,AAPL,106.503,0.236545965,3.81,-43.82022472,-61.36576239,-0.932610706,-198.3395014,-46556984,-1248878.988,32,96,-64,2.59,103.9933333,104.8566667,106.5833333,107.4466667,102.2666667,101.4033333,99.67666667,0,407222392,169571431.7,-1
9/12/2016,102.65,105.72,102.53,105.44,45292770,AAPL,106.353,0.235950186,1.38,-164.1693811,-37.59689922,-1.235266916,-152.2762104,37341688.12,505237.6988,28,96,-68,3.19,104.5633333,106.5966667,107.7533333,109.7866667,103.4066667,101.3733333,100.2166667,0.912225705,452515162,170585940.6,1
9/13/2016,107.51,108.79,107.24,107.95,62176190,AAPL,106.466,0.235941555,-1.95,-801.1111111,-13.2751938,-1.330515502,28.78954841,-5214777.226,245237.0204,24,96,-72,3.35,107.9933333,108.7466667,109.5433333,110.2966667,107.1966667,106.4433333,105.6466667,0.458064516,514691352,172066045.3,1
9/14/2016,108.73,113.03,108.6,111.77,112340318,AAPL,107.043,0.236962918,-5.67,294.9197861,-8.980755524,-1.188191092,191.7561336,48435667.58,2435711.137,20,92,-72,5.08,111.1333333,113.6666667,115.5633333,118.0966667,109.2366667,106.7033333,104.8066667,0.715575621,627031670,176041404.4,1
9/15/2016,113.86,115.73,113.49,115.57,90613177,AAPL,107.99,0.238803075,-8.84,185.375,-0.95636581,-0.886051649,322.1209601,77668437.43,5855380.514,96,88,8,3.96,114.93,116.37,117.17,118.61,114.13,112.69,111.89,0.928571429,717644847,179122106.5,1
9/16/2016,115.12,116.13,114.04,114.92,79886911,AAPL,108.809,0.240354244,-7.19,185.839599,-7.063631057,-0.499181994,235.3625749,-12613722.79,5015875.818,96,84,12,2.09,115.03,116.02,117.12,118.11,113.93,112.94,111.84,0.421052632,637757936,178672798.8,-1
9/19/2016,115.19,116.18,113.25,113.58,47023046,AAPL,109.394,0.241383566,-5.88,219.3786982,-15.1338766,-0.120222451,165.6609864,-36430824.03,3131934.916,96,80,16,2.93,114.3366667,115.4233333,117.2666667,118.3533333,112.4933333,111.4066667,109.5633333,0.112627986,590734890,178124496.6,-1
9/20/2016,113.05,114.12,112.51,113.57,34514269,AAPL,109.981,0.242413545,-5.21,195.9048877,-15.19208382,0.227638566,115.893368,10933091.42,3486532.939,96,76,20,1.61,113.4,114.29,115.01,115.9,112.68,111.79,111.07,0.658385093,556220621,178121457.9,-1
9/21/2016,113.85,113.989,112.441,113.55,36003185,AAPL,110.5,0.243290985,-8.03,197.7181208,-15.30849825,0.553876608,101.2254466,15582773.87,4036362.072,92,72,20,1.548,113.3266667,114.2123333,114.8746667,115.7603333,112.6643333,111.7786667,111.1163333,0.716408269,520217436,178115117.6,-1
9/22/2016,114.35,114.94,114,114.62,31073984,AAPL,111.41,0.245022458,-11.49,192.2686946,-9.08032596,0.939626821,113.506626,9917228.936,4303674.202,88,68,20,1.39,114.52,115.04,115.46,115.98,114.1,113.58,113.16,0.659574468,551291420,178407932.8,1
9/23/2016,114.42,114.79,111.55,112.71,52481151,AAPL,112.368,0.246848124,-7.27,284.5381526,-20.19790454,1.212671352,69.9714569,-14902055.22,3430686.501,84,64,20,3.24,113.0166667,114.4833333,116.2566667,117.7233333,111.2433333,109.7766667,108.0033333,0.358024691,498810269,177533399.5,-1
9/26/2016,111.64,113.39,111.55,112.88,29869442,AAPL,113.112,0.248201172,-4.93,276.8339768,-19.20838184,1.917268489,53.20934885,13311381.76,3879809.013,80,60,20,1.84,112.6066667,113.6633333,114.4466667,115.5033333,111.8233333,110.7666667,109.9833333,0.722826087,528679711,177578451.5,1
9/27/2016,113,113.18,112.34,113.09,24607412,AAPL,113.626,0.249048907,-1.32,293.6575053,-17.98603027,3.058353907,49.83400246,19334395.14,4582290.201,76,56,20,0.84,112.87,113.4,113.71,114.24,112.56,112.03,111.72,0.892857143,553287123,177624230.7,1
9/28/2016,113.69,114.64,113.43,113.95,29641085,AAPL,113.844,0.249251461,1.62,174.970344,-12.98020955,3.948830635,59.47039512,-4164449.959,4184711.102,72,52,20,1.55,114.0066667,114.5833333,115.2166667,115.7933333,113.3733333,112.7966667,112.1633333,0.429752066,582928208,177849638.2,1
9/29/2016,113.16,113.8,111.8,112.18,35886990,AAPL,113.505,0.248237964,2.74,162.9834254,-23.28288708,4.54746589,30.01847674,-22249933.8,2983136.334,68,48,20,2.15,112.5933333,113.3866667,114.5933333,115.3866667,111.3866667,110.5933333,109.3866667,0.19,547041218,177292200.9,-1
9/30/2016,112.46,113.37,111.8,113.05,36379106,AAPL,113.318,0.247559639,0.53,174.9014455,-18.21885914,4.630705095,28.14091425,21549406.74,3827057.716,64,44,20,1.57,112.74,113.68,114.31,115.25,112.11,111.17,110.54,0.796178344,583420324,177574335.2,1
10/3/2016,112.71,113.05,112.28,112.52,21701760,AAPL,113.212,0.247057677,1.05,236.3238512,-21.30384168,4.142975063,22.40209146,-8173390.13,3281582.814,60,40,20,0.77,112.6166667,112.9533333,113.3866667,113.7233333,112.1833333,111.8466667,111.4133333,0.311688312,561718564,177472593.2,-1
10/4/2016,113.06,114.31,112.63,113,29736835,AAPL,113.155,0.246664379,0.55,606.504065,-18.50989523,3.684293279,29.09013411,-16638467.2,2376125.995,56,36,20,1.79,113.3133333,113.9966667,114.9933333,115.6766667,112.3166667,111.6333333,110.6366667,0.220238095,591455399,177599447.8,1
10/5/2016,113.4,113.66,112.69,113.05,21453089,AAPL,113.105,0.246287341,1.57,-147.2222222,-18.21885914,3.380531612,22.68255626,-5529146.649,2016795.42,52,32,20,0.97,113.1333333,113.5766667,114.1033333,114.5466667,112.6066667,112.1633333,111.6366667,0.371134021,612908488,177608940.3,1
10/6/2016,113.7,114.34,113.13,113.89,28779313,AAPL,113.032,0.245863501,-1.18,-441.7475728,-13.32945285,3.033048882,30.44940298,7373212.421,2260268.92,48,28,20,1.29,113.7866667,114.4433333,114.9966667,115.6533333,113.2333333,112.5766667,112.0233333,0.628099174,641687801,177822780.4,1
10/7/2016,114.31,114.56,113.51,114.06,24358443,AAPL,113.167,0.245890389,-1.18,983.3333333,-12.33993015,2.684280126,28.92533701,1159925.857,2210253.327,44,24,20,1.05,114.0433333,114.5766667,115.0933333,115.6266667,113.5266667,112.9933333,112.4766667,0.523809524,666046244,177859139.5,1
10/10/2016,115.02,116.75,114.72,116.05,36235956,AAPL,113.484,0.24631425,-2.96,270.5645161,-3.943661972,2.258965151,62.09001452,11245641.52,2620952.79,40,20,20,2.69,115.84,116.96,117.87,118.99,114.93,113.81,112.9,0.655172414,702282200,178491346.7,1
10/11/2016,117.7,118.69,116.2,116.3,64041043,AAPL,113.805,0.246745649,-2.35,253.0909091,-12.13814119,2.156311195,85.57576734,-58897184.12,-175326.1608,96,16,80,2.64,117.0633333,117.9266667,119.5533333,120.4166667,115.4366667,114.5733333,112.9466667,0.040160643,766323243,178629306.7,1
10/12/2016,117.35,117.98,116.75,117.34,37586787,AAPL,114.144,0.247216548,-5.16,254.7794118,-6.856272219,2.062015709,87.95088114,-1527918.171,-236807.6158,96,12,84,1.68,117.3566667,117.9633333,118.5866667,119.1933333,116.7333333,116.1266667,115.5033333,0.479674797,803910030,178965422.5,1
10/13/2016,116.79,117.44,115.72,116.98,35192406,AAPL,114.624,0.247988004,-3.93,162.295082,-8.684611478,1.980615227,72.86982562,16368560.93,517981.8636,92,8,84,1.72,116.7133333,117.7066667,118.4333333,119.4266667,115.9866667,114.9933333,114.2666667,0.73255814,768717624,178857451.9,-1
10/14/2016,117.88,118.17,117.13,117.63,35652191,AAPL,115.082,0.248710928,-5.11,156,-5.383443372,1.623447451,98.29230096,-1371238.115,432108.2282,88,4,84,1.19,117.6433333,118.1566667,118.6833333,119.1966667,117.1166667,116.6033333,116.0766667,0.480769231,804369815,179055553.5,1
10/17/2016,117.33,117.84,116.78,117.55,23624896,AAPL,115.585,0.2495276,-4.55,161.4349776,-5.789740985,1.361973656,85.29915663,10698066.11,898742.6775,84,0,84,1.06,117.39,118,118.45,119.06,116.94,116.33,115.88,0.726415094,780744919,179039486.2,-1
10/18/2016,118.18,118.21,117.45,117.47,24553478,AAPL,116.032,0.250221114,-4.42,180.1136364,-6.196038598,1.132922482,88.00328522,-23261189.68,-199436.0662,80,0,80,0.76,117.71,117.97,118.47,118.73,117.21,116.95,116.45,0.026315789,756191441,179022776.1,-1
10/19/2016,117.25,117.76,113.8,117.12,20034594,AAPL,116.439,0.250825634,-3.23,128.340081,-7.973590655,1.139199333,42.39403383,13558765.64,425936.7384,76,0,76,3.96,116.2266667,118.6533333,120.1866667,122.6133333,114.6933333,112.2666667,110.7333333,0.838383838,736156847,178963083.3,-1
10/20/2016,116.86,117.38,116.33,117.06,24125801,AAPL,116.756,0.251235266,-3,136.4089776,-8.278313865,1.340898165,59.82943516,9420550.867,834782.8352,72,24,48,1.05,116.9233333,117.5166667,117.9733333,118.5666667,116.4666667,115.8733333,115.4166667,0.695238095,712031046,178950723.8,-1
10/21/2016,116.81,116.91,116.28,116.6,23192665,AAPL,117.01,0.251507612,-0.55,134.0686275,-10.61452514,1.794447123,44.56725346,368137.5397,813571.6854,68,20,48,0.78,116.5966667,116.9133333,117.2266667,117.5433333,116.2833333,115.9666667,115.6533333,0.507936508,688838381,178859585.7,-1
10/24/2016,117.1,117.74,117,117.65,23538673,AAPL,117.17,0.25158058,-1.35,129.8924731,-5.281868969,2.155598927,62.25645984,17813049.84,1586275.238,64,16,48,1.14,117.4633333,117.9266667,118.2033333,118.6666667,117.1866667,116.7233333,116.4466667,0.878378378,712377054,179071554.9,1
10/25/2016,117.95,118.36,117.31,118.25,48128970,AAPL,117.365,0.251729033,-0.91,126.7307692,-2.234636872,2.459852024,68.74318494,38044804.86,3243481.13,60,12,48,1.05,117.9733333,118.6366667,119.0233333,119.6866667,117.5866667,116.9233333,116.5366667,0.895238095,760506024,179317006.5,1
10/26/2016,114.31,115.7,113.31,115.59,66134219,AAPL,117.19,0.251082544,1.39,338.2352941,-15.7440325,2.446135784,-20.18013058,60046550.31,5825438.819,56,8,48,4.94,114.8666667,116.4233333,117.2566667,118.8133333,114.0333333,112.4766667,111.6433333,0.953974895,694371805,177829336.1,-1
10/27/2016,115.39,115.86,114.1,114.48,34562045,AAPL,116.94,0.250275728,3.15,1328.571429,-21.38141188,2.370066488,-25.34597,-19637525.57,4668031.347,52,4,48,1.76,114.8133333,115.5266667,116.5733333,117.2866667,113.7666667,113.0533333,112.0066667,0.215909091,659809760,177497440,-1
10/28/2016,113.87,115.21,113.45,113.72,37861662,AAPL,116.549,0.249169799,3.83,-154.0772532,-25.24123921,2.189253334,-47.34171563,-26245015.7,3262892.845,48,0,48,1.76,114.1266667,114.8033333,115.8866667,116.5633333,113.0433333,112.3666667,111.2833333,0.153409091,621948098,177246087.3,-1
10/31/2016,113.65,114.23,113.2,113.54,26419398,AAPL,116.148,0.248045487,3.93,-121.0144928,-26.15540884,1.916793342,-64.10766473,-8977465.34,2706512.927,44,0,44,1.03,113.6566667,114.1133333,114.6866667,115.1433333,113.0833333,112.6266667,112.0533333,0.330097087,595528700,177204269.7,-1
11/1/2016,113.46,113.77,110.53,111.49,43825812,AAPL,115.55,0.246502012,5.63,-39.31623932,-35.48553719,1.488518393,-117.2978625,-17854960.44,1771900.501,40,8,32,3.24,111.93,113.33,115.17,116.57,110.09,108.69,106.85,0.296296296,551702888,176412981,-1
11/2/2016,111.4,112.35,111.23,111.59,28331709,AAPL,114.997,0.245058756,5.47,-44.52690167,-34.96900826,1.049424663,-119.4954893,-10118467.5,1231429.229,36,96,-60,1.12,111.7233333,112.2166667,112.8433333,113.3366667,111.0966667,110.6033333,109.9766667,0.321428571,580034597,176438392.9,1
11/3/2016,110.98,111.46,109.55,109.83,26932602,AAPL,114.274,0.243256057,6.77,-22.43589744,-44.05991736,0.590979077,-150.9921227,-19036132.3,310176.4317,32,92,-60,2.04,110.28,111.01,112.19,112.92,109.1,108.37,107.19,0.146596859,553101995,176013611.3,-1
11/4/2016,108.53,110.25,108.11,108.84,30836997,AAPL,113.498,0.241344542,8.81,-20.09184845,-49.17355372,-0.001085788,-169.1840016,-9798671.944,-149316.6763,28,96,-68,2.14,109.0666667,110.0233333,111.2066667,112.1633333,107.8833333,106.9266667,105.7433333,0.341121495,522264998,175735648.8,-1
11/7/2016,110.08,110.51,109.46,110.41,32560000,AAPL,112.774,0.239552213,7.84,-47.02549575,-41.06404959,-0.543528989,-121.107662,26358095.24,1055565.683,24,96,-72,1.67,110.1266667,110.7933333,111.1766667,111.8433333,109.7433333,109.0766667,108.6933333,0.904761905,554824998,176205321.7,1
11/8/2016,110.31,111.72,109.7,111.06,24254179,AAPL,112.055,0.237777327,4.53,-65.51155116,-37.70661157,-1.087439995,-91.56468662,8404913.515,1389626.948,20,92,-72,2.02,110.8266667,111.9533333,112.8466667,113.9733333,109.9333333,108.8066667,107.9133333,0.673267327,579079177,176348109.6,1
11/9/2016,109.88,111.32,108.05,110.88,59176361,AAPL,111.584,0.236530055,3.6,-64.2394822,-38.63636364,-1.804395381,-94.85447847,43251224.09,3292426.819,16,88,-72,3.27,110.0833333,112.1166667,113.3533333,115.3866667,108.8466667,106.8133333,105.5766667,0.865443425,519902816,176252199.8,-1
11/10/2016,111.09,111.09,105.83,107.79,57134541,AAPL,110.915,0.234862703,5.93,-45.06242906,-54.59710744,-2.750398121,-120.4880428,-14555187.25,2481171.634,12,96,-84,5.26,108.2366667,110.6433333,113.4966667,115.9033333,105.3833333,102.9766667,100.1233333,0.372623574,462768275,174659976.4,-1
11/11/2016,107.12,108.87,106.55,108.43,34143898,AAPL,110.386,0.233496233,5.11,-38.61171367,-51.29132231,-3.337700831,-106.2799778,21192764.28,3331698.572,8,96,-88,2.32,107.95,109.35,110.27,111.67,107.03,105.63,104.71,0.810344828,496912173,174862704.8,1
11/14/2016,107.71,107.809,104.08,105.71,51175504,AAPL,109.603,0.231594145,5.78,-23.60446571,-65.34090909,-3.885556909,-126.9642044,-6436393.504,2887694.387,4,92,-88,4.35,105.8663333,107.6526667,109.5953333,111.3816667,103.9236667,102.1373333,100.1946667,0.437114508,445736669,173578951.5,-1
11/15/2016,106.57,107.68,106.1593,107.11,32264510,AAPL,109.165,0.230424963,4.48,-51.41509434,-51.89798339,-4.223130624,-88.89900469,8077266.362,3123584.022,0,96,-96,1.97,106.9831,107.8069,108.5038,109.3276,106.2862,105.4624,104.7655,0.625172618,478001179,174006255.6,1
11/16/2016,106.7,110.23,106.6,109.99,58840522,AAPL,109.005,0.229848433,-0.16,-161.247216,-34.81613286,-4.490600906,-46.19342742,51059957.11,5302510.071,36,92,-56,3.63,108.94,111.28,112.57,114.91,107.65,105.31,104.02,0.933884298,536841701,175588374,1
11/17/2016,109.81,110.35,108.83,109.95,27632003,AAPL,109.017,0.229633581,-1.11,-192.0424403,-32.44910549,-4.436787833,-27.71745829,13088843.53,5656434.319,32,88,-56,1.52,109.71,110.59,111.23,112.11,109.07,108.19,107.55,0.736842105,509209698,175578325.1,-1
11/18/2016,109.72,110.54,109.66,110.06,28428917,AAPL,109.139,0.229649517,0.35,-211.2068966,-27.38017072,-4.427816023,-17.1484553,-2584447,5281848.805,28,84,-56,0.88,110.0866667,110.5133333,110.9666667,111.3933333,109.6333333,109.2066667,108.7533333,0.454545455,537638615,175606766.9,1
11/21/2016,110.12,111.99,110.01,111.73,29264571,AAPL,109.271,0.22968974,-0.67,3758.333333,-13.81178064,-4.096629088,4.839163599,21578926.09,6022625.045,24,80,-56,1.98,111.2433333,112.4766667,113.2233333,114.4566667,110.4966667,109.2633333,108.5166667,0.868686869,566903186,176050814.1,1
11/22/2016,111.95,112.42,111.4,111.8,25965534,AAPL,109.345,0.229608648,-0.92,4280.952381,-4.619970194,-3.61113124,20.18225802,-5600409.294,5494305.302,20,76,-56,1.02,111.8733333,112.3466667,112.8933333,113.3666667,111.3266667,110.8533333,110.3066667,0.392156863,592868720,176067081.8,1
11/23/2016,111.36,111.51,110.33,111.23,27426394,AAPL,109.38,0.229444965,-3.44,642.1428571,-8.867362146,-3.340323158,10.06501137,14410478.2,5899585.889,16,72,-56,1.47,111.0233333,111.7166667,112.2033333,112.8966667,110.5366667,109.8433333,109.3566667,0.762711864,565442326,175927251.3,-1
11/25/2016,111.13,111.87,110.95,111.79,11475922,AAPL,109.78,0.230043178,-3.36,323.7288136,-4.694485842,-3.161724918,23.47103093,9480109.478,6062336.961,12,68,-56,0.92,111.5366667,112.1233333,112.4566667,113.0433333,111.2033333,110.6166667,110.2833333,0.913043478,576918248,175985028.1,1
11/28/2016,111.43,112.465,111.39,111.57,27193983,AAPL,110.094,0.2304598,-5.86,687.9310345,-6.646862235,-2.96582915,33.91762517,-18087160.79,4964632.518,8,64,-56,1.075,111.8083333,112.2266667,112.8833333,113.3016667,111.1516667,110.7333333,110.0766667,0.16744186,549724265,175931511.1,-1
11/29/2016,110.78,112.03,110.07,111.46,28528750,AAPL,110.669,0.231417236,-4.35,1832.5,-7.463795024,-2.357084986,25.52846326,11935497.45,5281490.015,4,60,-56,1.96,111.1866667,112.3033333,113.1466667,114.2633333,110.3433333,109.2266667,108.3833333,0.709183673,521195515,175903383.8,-1
11/30/2016,111.6,112.2,110.27,110.52,36162258,AAPL,111.01,0.231883397,-0.53,-2036.111111,-14.44485704,-1.756104267,23.88810554,-26793797.38,3823522.406,0,56,-56,1.93,110.9966667,111.7233333,112.9266667,113.6533333,109.7933333,109.0666667,107.8633333,0.129533679,485033257,175598408.7,-1
12/1/2016,110.365,110.94,109.03,109.49,37086862,AAPL,110.96,0.231534412,0.46,431.1764706,-22.0943186,-0.718234077,-1.585847568,-19223033.18,2775951.697,4,52,-48,1.91,109.82,110.61,111.73,112.52,108.7,107.91,106.79,0.240837696,447946395,175252774.7,-1
12/2/2016,109.17,110.09,108.85,109.9,26527997,AAPL,110.955,0.231280424,0.16,482.9931973,-19.0493873,0.034911301,-7.083841978,18398449.53,3486065.235,0,48,-48,1.24,109.6133333,110.3766667,110.8533333,111.6166667,109.1366667,108.3733333,107.8966667,0.846774194,474474392,175352112.3,1
12/5/2016,110,110.03,108.25,109.11,34324540,AAPL,110.86,0.230838933,2.62,208.8235294,-24.91645006,0.339563913,-26.09792936,-1157006.966,3275016.499,0,44,-44,1.78,109.13,110.01,110.91,111.79,108.23,107.35,106.45,0.483146067,440149852,175105375.4,-1
12/6/2016,109.5,110.36,109.19,109.95,26195462,AAPL,110.682,0.230228729,1.85,230.2816901,-18.67805421,0.637851522,-0.193206299,7836249.316,3482345.263,0,40,-40,1.25,109.8333333,110.4766667,111.0033333,111.6466667,109.3066667,108.6633333,108.1366667,0.64957265,466345314,175307045.2,1
12/7/2016,109.26,111.19,109.16,111.03,29998719,AAPL,110.605,0.229831186,0.2,455.7692308,-10.65725956,0.953503113,41.86275871,25269856.89,4472686.701,0,36,-36,2.03,110.46,111.76,112.49,113.79,109.73,108.43,107.7,0.921182266,496344033,175601712,1
12/8/2016,110.86,112.43,110.6,112.12,27068316,AAPL,110.694,0.229779599,-0.33,268.6635945,-2.562198292,0.948277933,141.8403483,17897629.7,5082911.383,68,32,36,1.83,111.7166667,112.8333333,113.5466667,114.6633333,111.0033333,109.8866667,109.1733333,0.830601093,523412349,175867446.2,1
12/9/2016,112.31,114.7,112.31,113.95,34402627,AAPL,110.91,0.229993713,-2.38,194.0874036,-4.777070064,0.983688853,272.7552573,12811020.1,5434189.052,64,28,36,2.58,113.6533333,114.9966667,116.0433333,117.3866667,112.6066667,111.2633333,110.2166667,0.686192469,557814976,176428958.9,1
12/12/2016,113.29,115,112.49,113.3,26374377,AAPL,111.083,0.230116948,-1.84,374.522293,-10.625,0.975638459,205.8836792,-9351870.729,4762095.425,96,24,72,2.51,113.5966667,114.7033333,116.1066667,117.2133333,112.1933333,111.0866667,109.6833333,0.322709163,531440599,176278512.7,-1
12/13/2016,113.84,115.92,113.75,115.19,43733811,AAPL,111.456,0.230655119,-4.67,227.1386431,-4.314420804,0.87748418,221.1588561,14309219.27,5196055.6,96,20,76,2.62,114.9533333,116.1566667,117.1233333,118.3266667,113.9866667,112.7833333,111.8166667,0.66359447,575174410,177008052.9,1
12/14/2016,115.04,116.2,114.98,115.19,34031834,AAPL,111.923,0.231384585,-5.7,194.4444444,-5.872093023,0.911082645,193.8226082,-22315956.72,3945509.585,96,16,80,1.22,115.4566667,115.9333333,116.6766667,117.1533333,114.7133333,114.2366667,113.4933333,0.172131148,575174410,177008052.9,-1
12/15/2016,115.38,116.73,115.23,115.82,46524544,AAPL,112.556,0.232453746,-5.92,192.8039702,-5.132543711,1.026449173,169.3977098,-9925236.053,3315021.147,96,12,84,1.54,115.9266667,116.6233333,117.4266667,118.1233333,115.1233333,114.4266667,113.6233333,0.393333333,621698954,177262506.1,1
12/16/2016,116.47,116.5,115.645,115.97,44351134,AAPL,113.163,0.233466338,-6.86,180,-4.286520023,1.284281658,143.050913,-10633897.63,2680979.385,96,8,88,0.855,116.0383333,116.4316667,116.8933333,117.2866667,115.5766667,115.1833333,114.7216667,0.380116959,666050088,177319945.8,1
12/19/2016,115.8,117.38,115.75,116.64,27779423,AAPL,113.916,0.234776154,-6.69,165.8301158,-4.026115343,1.541757577,138.5613149,2556388.62,2675316.168,92,4,88,1.63,116.59,117.43,118.22,119.06,115.8,114.96,114.17,0.54601227,693829511,177480437.4,1
12/20/2016,116.74,117.5,116.68,116.95,21424965,AAPL,114.616,0.235973842,-5.92,138.4136858,-2.972972973,1.83025202,129.8408509,-7315841.707,2221172.629,96,0,96,0.86,117.0433333,117.4066667,117.8633333,118.2266667,116.5866667,116.2233333,115.7666667,0.329268293,715254476,177537379.6,1
12/21/2016,116.8,117.4,116.78,117.06,23783165,AAPL,115.219,0.23696946,-4.94,119.0224571,-2.378378378,2.10630206,111.3583981,-2301596.613,2015592.208,96,0,96,0.62,117.08,117.38,117.7,118,116.76,116.46,116.14,0.451612903,739037641,177559749.4,1
12/22/2016,116.35,116.51,115.64,116.29,26085854,AAPL,115.636,0.23758016,-2.34,134.5852895,-6.540540541,2.382570114,71.47017191,12893008.3,2510020.213,92,0,92,1.42,116.1466667,116.6533333,117.0166667,117.5233333,115.7833333,115.2766667,114.9133333,0.747126437,712951787,177388161.3,-1
12/23/2016,115.59,116.52,115.59,116.52,14249484,AAPL,115.893,0.237862691,-3.22,119.1632928,-5.297297297,2.739247952,62.98873885,14249484,3043632.203,88,44,44,0.93,116.21,116.83,117.14,117.76,115.9,115.28,114.97,1,727201271,177416344.1,1
12/27/2016,116.52,117.8,116.49,117.26,18296855,AAPL,116.289,0.238429043,-2.07,119.4254446,-2.872340426,3.002674006,74.8091043,3212424.924,3051304.599,84,40,44,1.31,117.1833333,117.8766667,118.4933333,119.1866667,116.5666667,115.8733333,115.2566667,0.58778626,745498126,177532544.5,1
12/28/2016,117.52,118.0166,116.2,116.76,20905892,AAPL,116.446,0.2385056,-1.57,133.5078534,-6.607910983,3.036908166,59.87520551,-8016648.886,2548215.804,96,36,60,1.8166,116.9922,117.7844,118.8088,119.601,115.9678,115.1756,114.1512,0.308268193,724592234,177443401.2,-1
12/29/2016,116.45,117.1095,116.4,116.73,15039519,AAPL,116.6,0.238575507,-0.91,142.2993492,-6.76566789,3.285737379,47.08669465,-1049268.767,2384693.778,96,32,64,0.7095,116.7465,117.093,117.456,117.8025,116.3835,116.037,115.674,0.465116279,709552715,177439537,-1
12/30/2016,116.65,117.2,115.43,115.82,30586265,AAPL,116.6,0.238330044,0.15,252.9411765,-11.55096074,3.276645069,29.7152317,-17107571.95,1498681.7,92,28,64,1.77,116.15,116.87,117.92,118.64,115.1,114.38,113.33,0.220338983,678966450,177201093.6,-1
1/3/2017,115.8,116.33,114.76,116.15,28781865,AAPL,116.618,0.238122323,0.49,177.5438596,-9.815634761,3.246563434,17.35595204,22182201.69,2438841.699,88,24,64,1.57,115.7466667,116.7333333,117.3166667,118.3033333,115.1633333,114.1766667,113.5933333,0.885350318,707748315,177283100.3,1
7/6/2017,143.02,143.5,142.41,142.73,24128782,AAPL,144.531,0.261240792,2.9,-551.9230769,-11.26217532,-3.681312831,-41.22619171,-9961423.761,-634564.8088,20,48,-28,1.68,142.88,143.35,143.97,144.44,142.26,141.79,141.17,0.293577982,1036730660,185992501.9,-1
7/7/2017,142.9,144.75,142.9,144.18,19201712,AAPL,144.386,0.260743775,2.1,526.7015707,-8.319805195,-3.36780244,-18.24148976,7369305.686,-270752.5135,16,44,-28,2.02,143.9433333,144.9866667,145.7933333,146.8366667,143.1366667,142.0933333,141.2866667,0.691891892,1055932372,186187572.9,1
7/10/2017,144.11,145.95,143.37,145.06,21090636,AAPL,144.264,0.260290616,0.76,-536.71875,-6.534090909,-3.118055756,0.494888632,6539732.093,38814.96858,12,40,-28,2.58,144.7933333,146.2166667,147.3733333,148.7966667,143.6366667,142.2133333,141.0566667,0.65503876,1077023008,186316299.2,1
7/11/2017,144.73,145.85,144.38,145.53,19781836,AAPL,144.235,0.260006048,-1.8,1411.538462,-5.580357143,-2.675490822,9.939391282,11169335.97,544747.7415,8,36,-28,1.47,145.2533333,146.1266667,146.7233333,147.5966667,144.6566667,143.7833333,143.1866667,0.782312925,1096804844,186380393.1,1
7/12/2017,145.87,146.18,144.82,145.74,24884478,AAPL,144.436,0.260134558,0.09,-5146.153846,-5.154220779,-2.403313009,20.07821333,8782756.941,919202.7051,4,32,-28,1.36,145.58,146.34,146.94,147.7,144.98,144.22,143.62,0.676470588,1121689322,186416301.4,1
7/13/2017,145.5,148.49,145.44,147.77,25199373,AAPL,144.63,0.260253267,-4.09,407.4766355,-1.454839361,-1.978597547,64.78695531,13301964.11,1482055.496,0,28,-28,3.05,147.2333333,149.0266667,150.2833333,152.0766667,145.9766667,144.1833333,142.9266667,0.763934426,1146888695,186767301.3,1
7/14/2017,147.97,149.33,147.33,149.04,20132061,AAPL,145.166,0.260985297,-5.02,338.4057971,-0.576197099,-1.147939909,98.92675695,14293763.31,2064405.851,0,24,-24,2,148.5666667,149.8033333,150.5666667,151.8033333,147.8033333,146.5666667,145.8033333,0.855,1167020756,186940325.1,1
7/17/2017,148.82,150.9,148.57,149.56,23793456,AAPL,145.72,0.261748153,-6.06,263.6363636,-2.581888247,-0.577228564,120.2088067,-3574124.292,1808109.027,0,20,-20,2.33,149.6766667,150.7833333,152.0066667,153.1133333,148.4533333,147.3466667,146.1233333,0.424892704,1190814212,187023340.4,1
7/18/2017,149.2,150.13,148.67,150.08,17868792,AAPL,146.378,0.262695294,-5.99,163.4645669,-1.579961464,-0.036702896,107.6722023,16644902.14,2482508.713,96,16,80,1.46,149.6266667,150.5833333,151.0866667,152.0433333,149.1233333,148.1666667,147.6633333,0.965753425,1208683004,187085467.7,1
7/19/2017,150.48,151.42,149.95,151.02,20922969,AAPL,147.071,0.263703633,-8.29,177.6493256,-0.763067531,0.299584901,132.6200013,9536319.204,2803136.463,92,12,80,1.47,150.7966667,151.6433333,152.2666667,153.1133333,150.1733333,149.3266667,148.7033333,0.727891156,1229605973,187216515.1,1
7/20/2017,151.5,151.74,150.19,150.34,17243748,AAPL,147.832,0.264829168,-6.16,138.4384384,-2.654531665,0.805253465,118.5492087,-13906248.39,2043618.97,96,8,88,1.55,150.7566667,151.3233333,152.3066667,152.8733333,149.7733333,149.2066667,148.2233333,0.096774194,1212362225,187138871.4,-1
7/21/2017,149.99,150.44,148.88,150.27,26252630,AAPL,148.441,0.265680659,-5.21,142.08,-2.787258248,1.184419267,89.03346515,20530902.95,2883950.06,96,4,92,1.56,149.8633333,150.8466667,151.4233333,152.4066667,149.2866667,148.3033333,147.7266667,0.891025641,1186109595,187126647.9,-1
7/24/2017,150.58,152.44,149.9,152.09,21493160,AAPL,149.144,0.266699826,-6.56,124.5634459,-0.65494012,1.793560802,121.4615202,15569848.19,3460581.793,92,0,92,2.54,151.4766667,153.0533333,154.0166667,155.5933333,150.5133333,148.9366667,147.9733333,0.862204724,1207602755,187386963,1
7/25/2017,151.8,153.84,151.8,152.74,18853932,AAPL,149.865,0.267749088,-7,124.3930636,-2.005835157,2.154533883,138.7297427,-1478739.765,3236067.177,96,32,64,2.04,152.7933333,153.7866667,154.8333333,155.8266667,151.7466667,150.7533333,149.7066667,0.460784314,1226456687,187467540.7,1
7/26/2017,153.35,153.93,153.06,153.46,15780951,AAPL,150.637,0.268887062,-5.69,106.9897484,-0.855634444,2.719847071,132.5691501,-1269731.69,3031258.137,96,28,68,1.19,153.4833333,153.9066667,154.3533333,154.7766667,153.0366667,152.6133333,152.1666667,0.459770115,1242237638,187541930.4,1
7/27/2017,153.75,153.99,147.3,150.56,32476337,AAPL,150.916,0.269142282,-1.52,157.2100313,-6.237497727,3.121099133,59.55715332,-825258.1898,2855961.941,96,24,72,6.69,150.6166667,153.9333333,157.3066667,160.6233333,147.2433333,143.9266667,140.5533333,0.487294469,1209761301,186928211,-1
7/28/2017,149.89,150.23,149.19,149.5,17213653,AAPL,150.962,0.268981808,0.06,206.0810811,-8.165120931,3.567083391,32.61418293,-6951667.558,2410160.6,96,20,76,1.37,149.64,150.09,150.68,151.13,149.05,148.6,148.01,0.298076923,1192547648,186807020.3,-1
7/31/2017,149.9,150.33,148.13,148.73,19845920,AAPL,150.879,0.268591812,1.35,271.25,-9.565375523,3.735453624,16.25314957,-9020872.727,1890568.176,92,16,76,2.2,149.0633333,149.9966667,151.2633333,152.1966667,147.7966667,146.8633333,145.5966667,0.272727273,1172701728,186704803.9,-1
8/1/2017,157.06,158.92,156.6701,158.59,21194042,AAPL,151.73,0.269871337,-7.57,142.6459144,-0.550734312,4.03956675,169.8590088,14976846.69,2485399.018,88,12,76,10.19,158.0600333,159.4499667,160.3099333,161.6998667,157.2000667,155.8101333,154.9501667,0.853326815,1193895770,188109855,1
8/2/2017,159.28,159.75,156.16,157.14,69936800,AAPL,152.342,0.270722314,-6.8,173.959445,-4.296296296,4.247613322,128.7446704,-31754034.54,929061.1286,96,8,88,3.59,157.6833333,159.2066667,161.2733333,162.7966667,155.6166667,154.0933333,152.0266667,0.272980501,1123958970,187470417.7,-1
8/3/2017,157.05,157.21,155.02,155.57,27097296,AAPL,152.865,0.271411089,-5.3,230.1684533,-6.880658436,4.244936376,82.507946,-13486782.03,273795.5306,96,4,92,2.19,155.9333333,156.8466667,158.1233333,159.0366667,154.6566667,153.7433333,152.4666667,0.251141553,1096861674,187199686.2,-1
8/4/2017,156.07,157.4,155.69,156.39,20559852,AAPL,153.477,0.272256212,-4.3,224.4509517,-5.530864198,4.283439182,78.82058441,-3727224.632,91930.97774,92,0,92,1.83,156.4933333,157.2966667,158.2033333,159.0066667,155.5866667,154.7833333,153.8766667,0.409356725,1117421526,187308055.9,1
8/7/2017,157.06,158.92,156.6701,158.81,21870321,AAPL,154.149,0.273208499,-6.07,197.3654066,-1.547325103,4.366963532,90.59512357,19731794.57,984652.05,88,12,76,2.53,158.1333667,159.5966333,160.3832667,161.8465333,157.3467333,155.8834667,155.0968333,0.951108938,1139291847,187646480.2,1
8/8/2017,158.6,161.83,158.27,160.08,36205896,AAPL,154.883,0.274269283,-6.62,193.8189845,-2.78529365,4.550855918,102.9558891,610211.7303,967632.0355,84,8,76,3.56,160.06,161.85,163.62,165.41,158.29,156.5,154.73,0.508426966,1175497743,187936017.9,1
8/9/2017,159.26,161.27,159.11,161.06,26131530,AAPL,155.643,0.275374344,-10.5,172.9477612,-1.225529206,4.513562577,94.79994414,21050399.17,1880485.087,96,4,92,2.16,160.48,161.85,162.64,164.01,159.69,158.32,157.53,0.902777778,1201629273,188095993.6,1
8/10/2017,159.9,160,154.63,155.32,40804273,AAPL,156.119,0.275967728,-5.82,367.1287129,-10.36129238,4.302385086,38.63424417,-30318258.71,416905.8234,92,0,92,6.43,156.65,158.67,162.02,164.04,153.3,151.28,147.93,0.12849162,1160825000,186641774.5,-1
8/11/2017,156.6,158.5728,156.07,157.48,26257096,AAPL,156.917,0.277128601,-8.75,350.2782931,-6.923444215,3.964095341,42.30633175,3327773.234,549217.9785,88,0,88,3.2528,157.3742667,158.6785333,159.8770667,161.1813333,156.1757333,154.8714667,153.6729333,0.563369027,1187082096,187006925.9,1
8/14/2017,159.32,160.21,158.75,159.85,22122734,AAPL,158.029,0.278841239,-1.26,289.7327707,-3.151360815,4.196522983,64.82307885,11212892.58,1033930.46,84,0,84,2.73,159.6033333,160.4566667,161.0633333,161.9166667,158.9966667,158.1433333,157.5366667,0.753424658,1209204830,187339862.7,1
8/15/2017,160.66,162.195,160.14,161.6,29465487,AAPL,158.33,0.279129064,-4.46,265.7248157,-0.941530184,4.737613242,79.64553954,12402747.57,1550694.874,80,0,80,2.345,161.3116667,162.4833333,163.3666667,164.5383333,160.4283333,159.2566667,158.3733333,0.710462287,1238670317,187662443.9,1
8/16/2017,161.94,162.51,160.15,160.95,27671612,AAPL,158.711,0.279555127,-5.38,208.1809432,-2.456306094,5.48780028,71.5095568,-8911197.085,1075154.331,96,0,96,2.36,161.2033333,162.2566667,163.5633333,164.6166667,159.8966667,158.8433333,157.5366667,0.338983051,1210998705,187551141,-1
8/17/2017,160.52,160.71,157.84,157.86,27940565,AAPL,158.94,0.279708861,-1.47,258.7320574,-7.321681625,4.863186288,34.88568162,-27551149.46,-226041.2962,96,0,96,3.11,158.8033333,159.7666667,161.6733333,162.6366667,156.8966667,155.9333333,154.0266667,0.006968641,1183058140,187014723.8,-1
8/18/2017,157.86,159.5,156.72,157.5,27428069,AAPL,159.051,0.279654948,1.31,246.63626,-7.888521493,4.536034773,18.79244776,-12036778.48,-762892.9865,92,36,56,2.78,157.9066667,159.0933333,160.6866667,161.8733333,156.3133333,155.1266667,153.5333333,0.28057554,1155630071,186952174,-1
8/21/2017,157.5,157.89,155.1101,157.21,26368528,AAPL,158.891,0.279126743,2.87,-852.8985507,-8.345142497,4.499521364,1.60613229,13468352.43,-116018.195,88,32,56,2.7799,156.7367,158.3633,159.5166,161.1432,155.5834,153.9568,152.8035,0.755386884,1129261543,186903622.5,-1
8/22/2017,158.23,160,158.02,159.78,21604585,AAPL,158.861,0.278830749,1.28,543.1818182,-4.298535664,4.461601605,31.41893905,16803566.11,653053.8189,84,28,56,2.79,159.2666667,160.5133333,161.2466667,162.4933333,158.5333333,157.2866667,156.5533333,0.888888889,1150866128,187256804.7,1
8/23/2017,159.07,160.47,158.88,159.98,19399081,AAPL,158.753,0.278399501,-4.66,329.7052154,-3.983624626,4.133799672,37.10887098,7442414.723,961661.1327,80,24,56,1.59,159.7766667,160.6733333,161.3666667,162.2633333,159.0833333,158.1866667,157.4933333,0.691823899,1170265209,187281087,1
8/24/2017,160.43,160.74,158.55,159.27,19818918,AAPL,159.148,0.278845143,-1.79,476.3888889,-5.10155881,3.655717694,28.23865121,-6787300.685,609435.5955,76,20,56,2.19,159.52,160.49,161.71,162.68,158.3,157.33,156.11,0.328767123,1150446291,187193129.5,-1
8/25/2017,159.65,160.56,159.27,159.86,25480063,AAPL,159.386,0.27901679,-0.01,1132.380952,-4.172571249,2.982741579,27.88519382,-2172718.55,482974.0435,72,16,56,1.29,159.8966667,160.5233333,161.1866667,161.8133333,159.2333333,158.6066667,157.9433333,0.457364341,1175926354,187287517.9,1
8/28/2017,160.14,162,159.93,161.47,25965972,AAPL,159.548,0.279057952,0.13,879.8561151,-1.637537396,3.128016857,41.88599139,12669387.3,1036901.919,68,12,56,2.14,161.1333333,162.3366667,163.2033333,164.4066667,160.2666667,159.0633333,158.1966667,0.743961353,1201892326,187549029.3,1
8/29/2017,160.1,163.12,160,162.91,29516910,AAPL,159.679,0.279047079,-1.96,685.9459459,-0.327510917,3.155302014,60.42315905,25543479.81,2150837.278,64,8,56,3.12,162.01,164.02,165.13,167.14,160.9,158.89,157.78,0.932692308,1231409236,187812263.1,1
8/30/2017,163.8,163.89,162.61,163.35,27269584,AAPL,159.919,0.279226088,-5.49,163.5118306,-0.832177531,2.920141737,88.85024757,4260872.5,2246747.969,96,4,92,1.28,163.2833333,163.9566667,164.5633333,165.2366667,162.6766667,162.0033333,161.3966667,0.578125,1258678820,187885914.9,1
8/31/2017,163.64,164.52,163.48,164,26785096,AAPL,160.533,0.280054704,-6.5,178.2208589,-0.793650794,2.495462347,93.91094626,0,2144623.062,96,0,96,1.17,164,164.52,165.04,165.56,163.48,162.96,162.44,0.5,1285463916,187992497.7,1
9/1/2017,164.8,164.94,163.63,164.05,16591051,AAPL,161.188,0.280952134,-6.84,221.4285714,-1.349711859,1.962362981,88.21569213,-5952514.481,1776571.355,96,4,92,1.31,164.2066667,164.7833333,165.5166667,166.0933333,163.4733333,162.8966667,162.1633333,0.320610687,1302054967,187997556,1
9/5/2017,163.75,164.25,160.56,162.08,29536314,AAPL,161.675,0.281552859,-2.3,1572.916667,-4.337276312,1.735019571,44.11187855,-5202873.74,1459323.851,96,0,96,3.69,162.2966667,164.0333333,165.9866667,167.7233333,160.3433333,158.6066667,156.6533333,0.411924119,1272518653,187642868.2,-1
9/6/2017,162.71,162.99,160.52,161.91,21651726,AAPL,161.888,0.281677093,-1.93,786.4583333,-4.595086442,1.518627069,35.01136781,2717423.101,1516510.181,92,28,64,2.47,161.8066667,163.0933333,164.2766667,165.5633333,160.6233333,159.3366667,158.1533333,0.562753036,1250866927,187620158.4,-1
9/7/2017,162.09,162.24,160.36,161.26,21928502,AAPL,162.016,0.281652751,-1.99,222.0588235,-5.580831059,1.966600823,24.06230883,-933127.7447,1405163.002,88,24,64,1.88,161.2866667,162.2133333,163.1666667,164.0933333,160.3333333,159.4066667,158.4533333,0.478723404,1228938425,187532124.8,-1
9/8/2017,160.86,161.15,158.53,158.63,28611535,AAPL,161.952,0.281292401,1.23,668.1415929,-9.569305429,1.934188128,-31.99970882,-26427448.36,140044.3039,84,20,64,2.73,159.4366667,160.3433333,162.0566667,162.9633333,157.7233333,156.8166667,155.1033333,0.038167939,1200326890,187065497.4,-1
9/11/2017,160.5,162.05,159.89,161.5,31580798,AAPL,162.116,0.281330885,-0.03,242.8904429,-5.216863816,1.851771495,12.18061181,15497984.2,838132.4811,80,16,64,3.42,161.1466667,162.4033333,163.3066667,164.5633333,160.2433333,158.9866667,158.0833333,0.74537037,1231907688,187636870.3,1
9/12/2017,162.61,163.96,158.77,160.86,71714046,AAPL,162.055,0.280979834,2.05,726.8518519,-6.18744313,1.914346819,11.21139364,-13955912.61,165675.886,76,12,64,5.19,161.1966667,163.6233333,166.3866667,168.8133333,158.4333333,156.0066667,153.2433333,0.402697495,1160193642,187352678.4,-1
9/13/2017,159.87,159.96,157.91,159.65,44907361,AAPL,161.729,0.280170775,3.7,-2318.181818,-8.022444647,2.032741501,-47.42697403,31325622.55,1582037.098,72,8,64,2.95,159.1733333,160.4366667,161.2233333,162.4866667,158.3866667,157.1233333,156.3366667,0.848780488,1115286281,187014882.2,-1
9/14/2017,158.99,159.4,158.09,158.28,23760749,AAPL,161.222,0.279049756,5.72,-772.7272727,-10.10009099,1.980127534,-63.57191629,-16868317.99,743384.5939,68,4,64,1.56,158.59,159.09,159.9,160.4,157.78,157.28,156.47,0.145038168,1091525532,186810984.7,-1
9/15/2017,158.47,160.97,158,159.88,49114602,AAPL,160.81,0.27809734,4.17,43300,-7.673642705,1.817128112,-31.81057775,13064153.39,1303419.539,64,0,64,2.97,159.6166667,161.2333333,162.5866667,164.2033333,158.2633333,156.6466667,155.2933333,0.632996633,1140640134,187307467.9,1
9/18/2017,160.11,160.5,157.995,158.67,28269435,AAPL,160.272,0.276928695,3.41,-251.7857143,-9.508644222,1.178281721,-52.81516679,-13034410.15,651700.008,60,24,36,2.505,159.055,160.115,161.56,162.62,157.61,156.55,155.105,0.269461078,1112370699,187093519.9,-1
9/19/2017,159.51,159.77,158.44,158.73,20810632,AAPL,159.937,0.276111753,3.18,-135.645933,-9.417652411,0.537743821,-60.44257596,-11735318.8,88653.69872,56,20,36,1.33,158.98,159.52,160.31,160.85,158.19,157.65,156.86,0.218045113,1133181331,187101389.3,1
9/20/2017,157.9,158.26,153.83,156.07,52951364,AAPL,159.353,0.274865293,5.19,-71.84065934,-13.45162269,-0.082411446,-160.0580836,597645.1919,111789.6757,52,16,36,4.9,156.0533333,158.2766667,160.4833333,162.7066667,153.8466667,151.6233333,149.4166667,0.505643341,1080229967,186214029.4,-1
9/21/2017,155.8,155.8,152.75,153.39,37511661,AAPL,158.566,0.273269671,5.24,-43.16682375,-17.51592357,-0.441460535,-217.9007922,-21769062.29,-882794.5044,48,96,-48,3.32,153.98,155.21,157.03,158.26,152.16,150.93,149.11,0.209836066,1042718306,185569887.4,-1
9/22/2017,152.02,152.27,150.56,151.89,46645443,AAPL,157.892,0.271869401,9.61,-37.25328947,-19.79071884,-0.902917614,-266.8537341,25914135,335247.7458,44,96,-52,2.83,151.5733333,152.5866667,153.2833333,154.2966667,150.8766667,149.8633333,149.1666667,0.777777778,996072863,185113741.8,-1
9/25/2017,149.99,151.83,149.16,150.55,44387336,AAPL,156.797,0.269749676,10.31,-39.2888118,-20.99616858,-1.557736675,-249.6543565,1828691.745,403131.564,40,96,-56,2.73,150.5133333,151.8666667,153.1833333,154.5366667,149.1966667,147.8433333,146.5266667,0.520599251,951685527,184722149,-1
9/26/2017,151.78,153.92,151.69,153.14,36660045,AAPL,156.025,0.268191652,6.51,-81.18586089,-16.65640394,-1.858294044,-141.8140975,11014452.98,885464.3557,36,96,-60,3.37,152.9166667,154.1433333,155.1466667,156.3733333,151.9133333,150.6866667,149.6833333,0.650224215,988345572,185352833.3,1
9/27/2017,153.8,154.7189,153.54,154.23,25504227,AAPL,155.483,0.26703221,4.05,-116.7852063,-14.97844828,-2.589201227,-93.13825221,4350581.092,1042969.662,32,92,-60,1.5789,154.1629667,154.7859333,155.3418667,155.9648333,153.6070333,152.9840667,152.4281333,0.585291373,1013849799,185534364,1
9/28/2017,153.89,154.28,152.7,153.28,22005455,AAPL,154.983,0.265945887,6.6,-153.4579439,-16.4408867,-3.158260476,-91.00764613,-5849551.329,729673.2533,28,88,-60,1.58,153.42,154.14,155,155.72,152.56,151.84,150.98,0.367088608,991844344,185398818.5,-1
9/29/2017,153.21,154.13,152,154.12,26299810,AAPL,154.407,0.264733704,4.55,-83.7398374,-15.14778325,-3.581636329,-75.30152708,26052863.43,1880727.352,24,84,-60,2.13,153.4166667,154.8333333,155.5466667,156.9633333,152.7033333,151.2866667,150.5733333,0.995305164,1018144154,185542945.8,1
10/2/2017,154.26,154.45,152.72,153.81,18698842,AAPL,153.921,0.263677435,4.92,-87.65957447,-15.625,-3.909666984,-57.38987555,4863860.636,2016324.32,20,80,-60,1.73,153.66,154.6,155.39,156.33,152.87,151.93,151.14,0.630057803,999445312,185505334.6,-1
10/3/2017,154.01,155.09,153.91,154.48,16230293,AAPL,153.496,0.26272858,1.59,-132.4951644,-10.47280942,-4.449795672,-35.14150523,-550179.4237,1899665.058,16,76,-60,1.28,154.4933333,155.0766667,155.6733333,156.2566667,153.8966667,153.3133333,152.7166667,0.483050847,1015675605,185576034.2,1
10/4/2017,153.63,153.86,152.46,153.48,20163750,AAPL,153.237,0.26206305,-0.09,-142.7083333,-12.08649346,-4.79972312,-47.18272,9217714.286,2232303.66,12,72,-60,2.02,153.2666667,154.0733333,154.6666667,155.4733333,152.6733333,151.8666667,151.2733333,0.728571429,995511855,185445507.5,-1
10/5/2017,154.18,155.44,154.05,155.39,21283769,AAPL,153.437,0.262182429,-3.5,-159.4654788,-9.004356947,-5.065966674,-15.61818671,19752562.6,3028679.066,8,68,-60,1.96,154.96,155.87,156.35,157.26,154.48,153.57,153.09,0.964028777,1016795624,185710375.9,1
10/6/2017,154.97,155.49,154.56,155.3,17407558,AAPL,153.778,0.262540768,-4.75,-212.462908,-8.455284553,-4.968763687,-9.911372251,10294792.37,3358956.943,4,64,-60,0.93,155.1166667,155.6733333,156.0466667,156.6033333,154.7433333,154.1866667,153.8133333,0.795698925,999388066,185700293.7,-1
10/9/2017,155.81,156.73,155.485,155.84,16262923,AAPL,154.307,0.263217969,-2.7,-264.3598616,-6.467006747,-4.443479605,7.930608577,-6988484.984,2888618.674,0,60,-60,1.43,156.0183333,156.5516667,157.2633333,157.7966667,155.3066667,154.7733333,154.0616667,0.285140562,1015650989,185756842.2,1
10/10/2017,156.055,158,155.1,155.9,15617014,AAPL,154.583,0.263464162,-1.67,-4529.411765,-3.982450219,-3.671148534,16.97278384,-7000730.414,2439102.806,0,56,-56,2.9,156.3333333,157.5666667,159.2333333,160.4666667,154.6666667,153.4333333,151.7666667,0.275862069,1031268003,185762854.9,1
10/11/2017,155.97,156.98,155.75,156.55,16905640,AAPL,154.815,0.263635902,-3.27,264.2405063,-2.457627119,-2.76447639,21.94535696,5085436.423,2559390.698,16,52,-36,1.23,156.4266667,157.1033333,157.6566667,158.3333333,155.8733333,155.1966667,154.6433333,0.650406504,1048173643,185833340.2,1
10/12/2017,156.35,157.37,155.7299,156,16125054,AAPL,155.087,0.263873955,-1.88,203.163017,-3.389830508,-2.184671869,25.10610747,-10813942.38,1951511.922,12,48,-36,1.6401,156.3666333,157.0033667,158.0067333,158.6434667,155.3632667,154.7265333,153.7231667,0.16468508,1032048589,185776688.8,-1
10/13/2017,156.73,157.28,156.41,156.99,16394188,AAPL,155.374,0.264138022,-3.18,145.0310559,-1.711864407,-1.739182596,43.51122124,5464729.333,2111203.622,8,44,-36,1.28,156.8933333,157.3766667,157.7633333,158.2466667,156.5066667,156.0233333,155.6366667,0.666666667,1048442777,185880728.8,1
10/16/2017,157.9,160,157.65,159.88,24121452,AAPL,155.981,0.264946392,-5.4,143.0267062,-0.196721311,-1.221645557,110.4940328,21657984.56,2999693.665,4,40,-36,3.01,159.1766667,160.7033333,161.5266667,163.0533333,158.3533333,156.8266667,156.0033333,0.94893617,1072564229,186324776.2,1
10/17/2017,159.78,160.87,159.23,160.47,18997275,AAPL,156.58,0.265739848,-6.99,146.474359,-0.64651689,-0.582052194,142.2945137,9730311.585,3305630.843,0,36,-36,1.64,160.19,161.15,161.83,162.79,159.51,158.55,157.87,0.756097561,1091561504,186394881.2,1
10/18/2017,160.42,160.71,159.6,159.76,16374164,AAPL,157.208,0.266579018,-4.37,141.0493827,-1.79408437,0.091622304,129.5869052,-11653684.29,2625661.973,8,32,-24,1.11,160.0233333,160.4466667,161.1333333,161.5566667,159.3366667,158.9133333,158.2266667,0.144144144,1075187340,186322433.7,-1
10/19/2017,156.75,157.08,155.02,155.98,42584166,AAPL,157.267,0.266450914,-0.68,446.2365591,-7.903668983,0.547732947,20.61842305,-2894069.534,2374765.087,4,28,-24,4.74,156.0266667,157.0333333,158.0866667,159.0933333,154.9733333,153.9666667,152.9133333,0.466019417,1032603174,185314871.4,-1
10/20/2017,156.61,157.75,155.96,156.25,23974146,AAPL,157.362,0.266383991,-0.41,351.2295082,-7.467270082,1.098496219,33.78448615,-16205986.96,1530185.448,0,24,-24,1.79,156.6533333,157.3466667,158.4433333,159.1366667,155.5566667,154.8633333,153.7666667,0.162011173,1056577320,185356370.5,1
10/23/2017,156.89,157.69,155.5,156.17,21984327,AAPL,157.395,0.266212558,-0.27,467.4556213,-7.59657346,1.51883901,20.70230611,-8532729.658,1072780.216,84,20,64,2.19,156.4533333,157.4066667,158.6433333,159.5966667,155.2166667,154.2633333,153.0266667,0.305936073,1034592993,185345114.5,-1
10/24/2017,156.29,157.42,156.2,157.1,17757230,AAPL,157.515,0.26618904,-0.55,243.9226519,-6.093421691,1.925766292,30.350729,8441961.803,1407743.016,80,16,64,1.25,156.9066667,157.6133333,158.1266667,158.8333333,156.3933333,155.6866667,155.1733333,0.737704918,1052350223,185450859.7,1
10/25/2017,156.91,157.55,155.27,156.41,21207098,AAPL,157.501,0.2659392,-0.41,678.4313725,-7.208663326,2.270749176,10.82576226,-2.64E-07,1343754.697,76,12,64,2.28,156.41,157.55,158.69,159.83,155.27,154.13,152.99,0.5,1031143125,185357715.8,-1
10/26/2017,157.23,157.8295,156.78,157.41,17000469,AAPL,157.642,0.265951511,-0.42,375.3554502,-5.592371101,2.487220123,38.43217224,3409812.982,1437666.437,72,8,64,1.4195,157.3398333,157.8996667,158.3893333,158.9491667,156.8501667,156.2903333,155.8006667,0.60028585,1048143594,185466407.5,1
10/27/2017,159.29,163.6,158.7,163.05,44454160,AAPL,158.248,0.266751818,-3.17,180.5825243,-0.851393189,2.60688199,185.3027415,34474654.69,2939347.721,68,4,64,6.19,161.7833333,164.8666667,166.6833333,169.7666667,159.9666667,156.8833333,155.0666667,0.887755102,1092597754,187059200,1
10/30/2017,163.89,168.07,163.72,166.72,44700772,AAPL,158.932,0.267685884,-6.25,153.6968577,-1.954538874,2.832097107,274.1448366,16955465.24,3576443.972,96,0,96,5.02,166.17,168.62,170.52,172.97,164.27,161.82,159.92,0.689655172,1137298526,188065344.3,1
10/31/2017,167.9,169.6499,166.94,169.04,36046828,AAPL,159.789,0.268910465,-9.28,146.5172138,-0.863270861,2.937666908,259.1744495,19821166.24,4314840.439,96,0,96,2.9299,168.5433,170.1466,171.2532,172.8565,167.4367,165.8334,164.7268,0.774936345,1173345354,188566955.7,1
11/1/2017,169.87,169.94,165.61,166.89,33637762,AAPL,160.502,0.269887717,-10.91,168.0440771,-4.29940795,2.780983628,173.2058587,-13750309.18,3493697.275,96,8,88,4.33,167.48,169.35,171.81,173.68,165.02,163.15,160.69,0.295612009,1139707592,188139120.9,-1
11/2/2017,167.64,168.5,165.28,168.11,41393373,AAPL,161.715,0.27170015,-11.86,166.6366906,-2.57964477,2.64894678,135.9796115,31366406.87,4760638.62,96,4,92,3.22,167.2966667,169.3133333,170.5166667,172.5333333,166.0933333,164.0766667,162.8733333,0.878881988,1181100965,188441714.9,1
11/3/2017,174,174.26,171.12,172.5,59398631,AAPL,163.34,0.2742024,-16.33,158.7163233,-2.33855966,2.682021729,191.671622,-7188369.357,4217501.894,92,0,92,6.15,172.6266667,174.1333333,175.7666667,177.2733333,170.9933333,169.4866667,167.8533333,0.439490446,1240499596,189992842.1,1
11/6/2017,172.365,174.99,171.72,174.25,35026306,AAPL,165.148,0.277006132,-17.15,153.7735849,-0.973812344,3.390181064,170.9813019,19173421.33,4897316.413,96,8,88,3.27,173.6533333,175.5866667,176.9233333,178.8566667,172.3166667,170.3833333,169.0466667,0.773700306,1275525902,190348181.4,1
11/7/2017,173.91,175.25,173.6,174.81,24361485,AAPL,166.919,0.279741692,-18.4,144.5182724,-0.57704918,4.154495084,154.395614,11368693,5191469.895,96,4,92,1.65,174.5533333,175.5066667,176.2033333,177.1566667,173.8566667,172.9033333,172.2066667,0.733333333,1299887387,190426473.7,1
11/8/2017,174.66,176.24,174.33,176.24,24409527,AAPL,168.902,0.282825524,-18.83,114.4126357,0,5.117866856,141.2681626,24409527,6065017.945,96,0,96,1.91,175.6033333,176.8766667,177.5133333,178.7866667,174.9666667,173.6933333,173.0566667,1,1324296914,190626151.2,1
11/9/2017,175.11,176.095,173.14,175.88,29185668,AAPL,170.749,0.285674443,-12.83,116.7091187,-0.466079751,6.00374341,108.9851125,24938684.16,6922911.864,96,0,96,3.1,175.0383333,176.9366667,177.9933333,179.8916667,173.9816667,172.0833333,171.0266667,0.927241963,1295111246,190566534.5,-1
11/10/2017,175.11,175.38,174.27,174.67,25145500,AAPL,171.911,0.287374574,-7.95,123.8378378,-2.032625583,7.203122736,88.35603785,-7022617.117,6289024.183,92,0,92,1.61,174.7733333,175.2766667,175.8833333,176.3866667,174.1666667,173.6633333,173.0566667,0.36036036,1269965746,190393541.3,-1
11/13/2017,173.5,174.5,173.4,173.97,16982080,AAPL,172.636,0.288342761,-4.93,130.2904564,-2.938891766,8.384231933,68.47043356,617530.1818,6031229.001,88,32,56,1.27,173.9566667,174.5133333,175.0566667,175.6133333,173.4133333,172.8566667,172.3133333,0.518181818,1252983666,190325484.6,-1
11/14/2017,173.04,173.48,171.18,171.34,24782487,AAPL,172.866,0.288482408,-4.45,147.2203617,-6.343863283,8.871173865,44.73837049,-21334488.81,4787332.737,84,28,56,2.79,172,172.82,174.3,175.12,170.52,169.7,168.22,0.069565217,1228201179,189950834.2,-1
11/15/2017,169.97,170.3197,168.38,169.08,29158070,AAPL,173.085,0.288600107,-0.97,179.7772065,-9.269808389,8.855868073,19.31199623,-8112909.408,4200958.094,80,24,56,2.96,169.2599,170.1398,171.1996,172.0795,168.2001,167.3202,166.2604,0.360880549,1199043109,189566234.9,-1
11/16/2017,171.18,171.87,170.3,171.1,23637484,AAPL,173.384,0.288852793,1.4,215.6521739,-6.654583118,8.630125374,26.8715165,451671.6688,4030535.984,76,20,56,2.79,171.09,171.88,172.66,173.45,170.31,169.52,168.74,0.50955414,1222680593,189848632.1,1
11/17/2017,171.04,171.39,169.64,170.15,21899544,AAPL,173.149,0.288218502,4.1,399.1253644,-7.884515795,8.663506709,17.02890707,-9135238.354,3432091.696,72,16,56,1.75,170.3933333,171.1466667,172.1433333,172.8966667,169.3966667,168.6433333,167.6466667,0.291428571,1200781049,189727039.1,-1
11/20/2017,170.29,170.56,169.56,169.98,16262447,AAPL,172.722,0.287267482,4.83,1209.574468,-8.104609011,8.617107514,9.930359952,-2601991.52,3157815.186,68,12,56,1,170.0333333,170.5066667,171.0333333,171.5066667,169.5066667,169.0333333,168.5066667,0.42,1184518602,189710791,-1
11/21/2017,170.78,173.7,170.78,173.14,25131295,AAPL,172.555,0.286753107,3.1,232.48,-4.013464526,8.232762156,25.14416908,15491894.18,3718455.14,64,8,56,3.72,172.54,174.3,175.46,177.22,171.38,169.62,168.46,0.808219178,1209649897,190177992.3,1
11/22/2017,173.36,175,173.05,174.96,25588925,AAPL,172.427,0.286306786,0.92,220.8759124,-1.65717245,7.672057393,34.41340132,24539122.95,4664849.131,60,4,56,1.95,174.3366667,175.6233333,176.2866667,177.5733333,173.6733333,172.3866667,171.7233333,0.979487179,1235238822,190446976.1,1
11/24/2017,175.1,175.5,174.6459,174.97,14026673,AAPL,172.336,0.285922494,-0.3,435.2226721,-1.64422579,6.961214012,34.09014354,-3381444.761,4299108.5,56,0,56,0.8541,175.0386333,175.4313667,175.8927333,176.2854667,174.5772667,174.1845333,173.7231667,0.379463763,1249265495,190447777.8,1
11/27/2017,175.05,175.08,173.34,174.09,20716802,AAPL,172.278,0.285592203,-0.12,-5625,-2.783531849,5.748088029,22.38540133,-2857489.931,3973808.571,52,12,40,1.74,174.17,175,175.91,176.74,173.26,172.43,171.52,0.431034483,1228548693,190343584,-1
11/28/2017,174.3,174.87,171.86,173.07,26428802,AAPL,172.188,0.285208372,-1.73,-485.0574713,-4.104091144,4.506617873,11.03695262,-5180396.405,3557708.345,48,8,40,3.01,173.2666667,174.6733333,176.2766667,177.6833333,171.6633333,170.2566667,168.6533333,0.401993355,1202119891,190188736.6,-1
11/29/2017,172.63,172.92,167.16,169.48,41666364,AAPL,172.002,0.284662223,-0.4,-103.6982249,-8.751941999,3.26711255,-32.48041548,-8101793,3027731.011,44,4,40,5.91,169.8533333,172.5466667,175.6133333,178.3066667,166.7866667,164.0933333,161.0266667,0.402777778,1160453527,189324449.1,-1
11/30/2017,170.43,172.14,168.44,171.85,41527218,AAPL,172.279,0.284882613,-0.75,-232.7543424,-5.506193657,2.172097149,-25.83305508,35017545.99,4481813.51,40,0,40,3.7,170.81,173.18,174.51,176.88,169.48,167.11,165.78,0.921621622,1201980745,189905163.7,1
12/1/2017,169.95,171.67,168.5,171.05,39759288,AAPL,172.274,0.284637358,-0.9,-259.1160221,-5.816993464,1.329181765,-40.47423579,24206758.94,5378401.939,36,0,36,3.35,170.4066667,172.3133333,173.5766667,175.4833333,169.1433333,167.2366667,165.9733333,0.804416404,1162221457,189720075.3,-1
12/4/2017,172.48,172.62,169.63,169.8,32542385,AAPL,172.239,0.284341512,0.18,-224.940048,-7.450980392,0.807564588,-39.61439633,-28841913.13,3822933.072,32,0,32,2.99,170.6833333,171.7366667,173.6733333,174.7266667,168.7466667,167.6933333,165.7566667,0.056856187,1129679072,189482261.9,-1
12/5/2017,169.06,171.52,168.4,169.64,27350154,AAPL,172.205,0.284047631,3.5,-551.7647059,-7.660130719,0.342462693,-62.08546675,-5610288,3394150.296,28,0,28,3.12,169.8533333,171.3066667,172.9733333,174.4266667,168.1866667,166.7333333,165.0666667,0.397435897,1102328918,189456490.3,-1
12/6/2017,167.5,170.2047,166.46,169.01,28560000,AAPL,171.792,0.283131613,5.95,-13400,-8.483660131,0.210632164,-94.75051002,10336573.82,3709715.002,24,8,16,3.7447,168.5582333,170.6564667,172.3029333,174.4011667,166.9117667,164.8135333,163.1670667,0.680962427,1073768918,189350425.7,-1
12/7/2017,169.03,170.44,168.91,169.32,25673308,AAPL,171.228,0.281970548,5.65,-430.8988764,-8.078431373,0.258779599,-58.29005158,-11913757.31,2999557.17,20,4,16,1.53,169.5566667,170.2033333,171.0866667,171.7333333,168.6733333,168.0266667,167.1433333,0.267973856,1099442226,189397516,1
12/8/2017,170.49,171,168.82,169.37,23355231,AAPL,170.668,0.280818775,4.72,-989.7435897,-8.013071895,-0.269075355,-48.82956226,-11570481.41,2337282.689,16,0,16,2.18,169.73,170.64,171.91,172.82,168.46,167.55,166.28,0.252293578,1122797457,189404412.7,1
12/11/2017,169.2,172.89,168.79,172.67,35273759,AAPL,170.526,0.280358234,0.4,409.6654275,-3.699346405,-0.931346057,2.797233982,31488282.42,3662328.131,12,88,-76,4.1,171.45,174.11,175.55,178.21,170.01,167.35,165.91,0.946341463,1158071216,190091685.6,1
12/12/2017,172.15,172.39,171.461,171.7,19409230,AAPL,170.389,0.279905502,-2.22,-545.8333333,-4.967320261,-1.391225448,17.46578704,-9422564.833,3067560.269,8,84,-76,1.209,171.8503333,172.2396667,172.7793333,173.1686667,171.3106667,170.9213333,170.3816667,0.257265877,1138661986,189982651.3,-1
12/13/2017,172.5,173.54,172,172.27,23818447,AAPL,170.668,0.280134195,-0.42,-245.7249071,-4.222222222,-1.644407501,41.36012305,-15466524.03,2225101.892,4,80,-76,1.84,172.6033333,173.2066667,174.1433333,174.7466667,171.6666667,171.0633333,170.1266667,0.175324675,1162480433,190061722.4,1
12/14/2017,172.4,173.13,171.65,172.22,20476541,AAPL,170.705,0.27996697,-1.17,-240,-4.287581699,-1.747632924,30.8326181,-4704070.23,1910139.523,0,76,-76,1.48,172.3333333,173.0166667,173.8133333,174.4966667,171.5366667,170.8533333,170.0566667,0.385135135,1142003892,190055779.3,-1
12/15/2017,173.63,174.17,172.46,173.97,40169307,AAPL,170.997,0.280218303,-4.17,-6958.333333,-1.458990536,-1.21915602,75.29360381,30772977.88,3222086.721,0,72,-72,1.95,173.5333333,174.6066667,175.2433333,176.3166667,172.8966667,171.8233333,171.1866667,0.883040936,1182173199,190463956.5,1
12/18/2017,174.88,177.2,174.86,176.42,29421114,AAPL,171.659,0.281075207,-6.78,322.3880597,-0.997442455,-0.951010152,165.8111299,9807038,3521402.688,36,68,-32,3.23,176.16,177.46,178.5,179.8,175.12,173.82,172.78,0.666666667,1211594313,190878290.8,1
12/19/2017,175.03,175.39,174.09,174.54,27436447,AAPL,172.149,0.281647173,-5.53,213.4387352,-3.401534527,-0.67543783,87.82055492,-8441983.692,2977612.398,96,64,32,2.33,174.6733333,175.2566667,175.9733333,176.5566667,173.9566667,173.3733333,172.6566667,0.346153846,1184157866,190585917.3,-1
12/20/2017,174.87,175.42,173.25,174.35,23475649,AAPL,172.683,0.282288897,-5.03,337.2,-3.644501279,-0.249848694,73.25157984,324548.1429,2857018.568,92,60,32,2.17,174.34,175.43,176.51,177.6,173.26,172.17,171.09,0.506912442,1160682217,190560362.3,-1
12/21/2017,174.17,176.02,174.1,175.01,20949896,AAPL,173.252,0.282986652,-5.64,229.5454545,-2.800511509,0.085874484,94.09199084,-1091140.417,2677556.796,88,56,32,1.92,175.0433333,175.9866667,176.9633333,177.9066667,174.0666667,173.1233333,172.1466667,0.473958333,1181632113,190639667.9,1
12/22/2017,174.68,175.424,174.5,175.01,16349444,AAPL,173.816,0.283674389,-2.34,174.4721689,-2.800511509,0.406489789,90.16876707,1698643.532,2633060.739,84,52,32,0.924,174.978,175.456,175.902,176.38,174.532,174.054,173.608,0.551948052,1181632113,190639667.9,-1
12/26/2017,170.8,171.47,169.679,170.57,33185536,AAPL,173.606,0.283097864,1.13,977.4193548,-8.47826087,0.73930236,-45.20613692,-166761.4874,2505796.092,80,48,32,5.331,170.573,171.467,172.364,173.258,169.676,168.782,167.885,0.497487437,1148446577,189797751.6,-1
12/27/2017,170.1,170.78,169.71,170.6,21498213,AAPL,173.496,0.282684807,1.67,573.5849057,-8.439897698,1.038941809,-49.02880144,14265169.37,3040313.06,76,44,32,1.07,170.3633333,171.0166667,171.4333333,172.0866667,169.9466667,169.2933333,168.8766667,0.831775701,1169944790,189801532.7,1
12/28/2017,171,171.85,170.48,171.08,16480187,AAPL,173.377,0.282258624,1.14,527.8409091,-7.826086957,0.900714173,-27.88303883,-2044986.708,2809163.07,72,40,32,1.37,171.1366667,171.7933333,172.5066667,173.1633333,170.4233333,169.7666667,169.0533333,0.437956204,1186424977,189847901.3,1
12/29/2017,170.52,170.59,169.22,169.23,25999922,AAPL,173.078,0.281539349,4.74,-6600,-10.19181586,1.046252142,-81.35011789,-25620361.09,1516911.972,68,36,32,1.86,169.68,170.14,171.05,171.51,168.77,168.31,167.4,0.00729927,1160425055,189566747.2,-1
1/2/2018,170.16,172.3,169.26,172.26,25555934,AAPL,172.907,0.281032769,4.16,-2187.804878,-6.31713555,1.310494497,-23.53001182,24883409.42,2579025.492,64,32,32,3.07,171.2733333,173.2866667,174.3133333,176.3266667,170.2466667,168.2333333,167.2066667,0.986842105,1185980989,190024316.6,1
1/23/2018,177.3,179.44,176.82,177.04,32689146,AAPL,176.804,0.284145583,-2.71,181.5899582,-3.773119605,1.885070656,92.10783391,-27199365.76,1517365.564,88,40,48,2.62,177.7666667,178.7133333,180.3866667,181.3333333,176.0933333,175.1466667,173.4733333,0.083969466,1189701625,190763356.8,1
1/24/2018,177.25,177.3,173.2,174.22,51105090,AAPL,176.793,0.283896515,0.07,436.1809045,-7.250308261,1.822070714,10.23149738,-25677191.56,281249.3307,84,36,48,4.1,174.9066667,176.6133333,179.0066667,180.7133333,172.5133333,170.8066667,168.4133333,0.248780488,1138596535,189949324.1,-1
1/25/2018,174.505,174.95,170.53,171.11,41529004,AAPL,176.475,0.283153447,4.17,-410.4166667,-11.08508015,1.883045414,-64.07208152,-30629989.38,-1123806.974,80,32,48,4.42,172.1966667,173.8633333,176.6166667,178.2833333,169.4433333,167.7766667,165.0233333,0.131221719,1097067531,189207990.2,-1
1/26/2018,172,172,170.06,171.51,39143011,AAPL,176.098,0.282318329,5.58,-180.8022923,-10.5918619,2.114847866,-87.70717416,19369737.4,-192282.2298,76,28,48,1.94,171.19,172.32,173.13,174.26,170.38,169.25,168.44,0.74742268,1136210542,189299493.9,1
1/29/2018,170.16,170.16,167.07,167.96,50640406,AAPL,175.185,0.280625621,8.23,-98.74804382,-14.96917386,2.153228456,-149.3243052,-21468909.99,-1159401.673,72,24,48,4.44,168.3966667,169.7233333,171.4866667,172.8133333,166.6333333,165.3066667,163.5433333,0.28802589,1085570136,188251313.4,-1
1/30/2018,165.525,167.37,164.7,166.97,46048185,AAPL,174.263,0.278921189,12.13,-85.73369565,-16.18988903,2.006669514,-175.9833417,32250976.01,359251.8578,68,96,-28,3.26,166.3466667,167.9933333,169.0166667,170.6633333,165.3233333,163.6766667,162.6533333,0.850187266,1039521951,187979893.4,-1
1/31/2018,166.87,168.4417,166.5,167.43,32478930,AAPL,173.096,0.276831133,11.83,-98.68804665,-15.62268804,1.630239515,-127.2584141,-1366600.701,280804.0142,64,96,-32,1.9417,167.4572333,168.4144667,169.3989333,170.3561667,166.4727667,165.5155333,164.5310667,0.478961735,1072000881,188069372.4,1
2/1/2018,167.165,168.62,166.76,167.78,47230787,AAPL,171.948,0.274776587,10.68,-81.73333333,-15.19112207,1.343808042,-104.7179559,4570721.323,475800.2555,60,92,-32,1.86,167.72,168.68,169.58,170.54,166.82,165.86,164.96,0.548387097,1119231668,188168104.8,1
2/2/2018,166,166.8,160.1,160.5,86593825,AAPL,170.152,0.271687297,16.5,-26.039783,-24.1676942,0.132534091,-171.6222964,-76254263.81,-3011929.929,56,88,-32,7.68,162.4666667,164.8333333,169.1666667,171.5333333,158.1333333,155.7666667,151.4333333,0.059701493,1032637843,184410785.4,-1
2/5/2018,159.1,163.88,156,156.49,72738522,AAPL,168.101,0.268195038,20.55,-21.92893401,-29.11220715,-1.324985787,-192.3611269,-63692360.63,-5770131.325,52,96,-44,7.88,158.79,161.58,166.67,169.46,153.7,150.91,145.82,0.062182741,959899321,182593455.4,-1
2/6/2018,154.83,163.72,154,163.03,68243838,AAPL,166.7,0.265751017,11.19,-49.47106409,-21.04808878,-2.618943386,-140.4721435,58554898.04,-2846266.354,48,96,-48,9.72,160.25,166.5,169.97,176.22,156.78,150.53,147.06,0.929012346,1028143159,185445488.8,1
2/7/2018,163.085,163.4,159.0685,159.54,51608580,AAPL,165.232,0.263201967,11.57,-39.5030426,-25.351418,-4.039507982,-115.6220245,-40373005.5,-4552027.224,44,96,-52,4.3315,160.6695,162.2705,165.001,166.602,157.939,156.338,153.6075,0.108853746,976534579,184340698.6,-1
