date,open,high,low,close,volume,Name,SMA,WMA,Momentum,RSI,WilliamK,MACD,CCI,acc_dist,AD-:21,Arronup,AroonDown,AroonOscillator,ATR,Pivot_Point,Resistance_1,Resistance_2,Resistance_3,Support_1,Support_2,Support_3,SO%k,On_Balance_Volume,Price_Volume_Trend,y
3/28/2013,64.2599,64.5455,63.0885,63.2371,110698007,AAPL,64.85773,4.373956846,0.1428,411.5042549,-60.90074046,0.910044242,15.71936809,-88117740.92,-14929463.45,88,28,60,1.4943,63.6237,64.1589,65.0807,65.6159,62.7019,62.1667,61.2449,0.101990391,-513689512,152475650.7,-1
4/1/2013,63.1285,63.3854,61.1057,61.2728,97294421,AAPL,64.64702,4.208570876,3.83,-433.8125,-91.58621552,1.260181301,-42.97256767,-83031230.45,-18780984.29,84,24,60,2.2797,61.9213,62.7369,64.201,65.0166,60.4572,59.6416,58.1775,0.073299118,-610983933,149453446.5,-1
4/2/2013,61.0857,62.5914,60.9142,61.3988,132350022,AAPL,64.27662,4.046805946,3.5283,2918.191161,-90.06106846,1.600330958,-56.72614972,-55869196.03,-20855493.18,80,20,60,1.6772,61.6348,62.3554,63.312,64.0326,60.6782,59.9576,59.001,0.288933938,-478633911,149725608,1
4/3/2013,61.6242,62.4685,61.4728,61.7128,90719482,AAPL,63.95519,3.899273985,2.87,1152.461538,-85.13163472,1.673483665,-49.41607193,-46986077,-22301934.55,76,16,60,1.0697,61.8847,62.2966,62.8804,63.2923,61.3009,60.889,60.3052,0.241036457,-387914429,150189557.1,1
4/4/2013,61.9657,62.1428,60.7499,61.1028,89589332,AAPL,63.60719,3.75910267,3.5728,-790.7307073,-94.47358943,1.543815272,-71.3343136,-44193287.4,-23501837.27,72,12,60,1.3929,61.33183333,61.91376667,62.72473333,63.30666667,60.52086667,59.93893333,59.12796667,0.253356307,-477503761,149304011.6,-1
4/5/2013,60.6428,60.7071,59.9542,60.4571,95743088,AAPL,63.18534,3.623326683,5.53,-130.2073354,-92.99718718,1.363996692,-102.7585484,32160216.44,-20479187.79,68,8,60,1.1486,60.3728,60.7914,61.1257,61.5443,60.0385,59.6199,59.2856,0.667950591,-573246849,148292252.6,-1
4/8/2013,60.6928,61.0714,60.3557,60.8871,75169647,AAPL,62.67534,3.492656349,5.3385,-59.60575942,-87.00949676,1.193400196,-78.83161265,36455755.87,-17414535.06,64,4,60,0.7157,60.7714,61.1871,61.4871,61.9028,60.4714,60.0557,59.7557,0.74248987,-498077202,148826895.3,1
4/9/2013,60.9085,61.2142,60.3928,60.9971,76615504,AAPL,62.15249,3.369600982,4.8794,-66.73791349,-85.477762,0.893871515,-72.18424468,36115806.12,-14557067.6,60,0,60,0.8214,60.86803333,61.34326667,61.68943333,62.16466667,60.52186667,60.04663333,59.70046667,0.735695155,-421461698,148965310.6,1
4/10/2013,61.1571,62.4371,60.8585,62.2414,93895844,AAPL,61.78898,3.262834306,2.3414,-165.161869,-68.1510569,0.317723377,-40.96518662,70615194.47,-10046295.27,56,88,-32,1.5786,61.84566667,62.83283333,63.42426667,64.41143333,61.25423333,60.26706667,59.67563333,0.876029393,-327565854,150880722.9,1
4/11/2013,61.9599,62.5699,61.5999,62.0471,82073628,AAPL,61.53541,3.166658061,1.19,-143.5914019,-70.85665748,-0.244075357,-35.7562566,-6396666.265,-9854448.813,52,84,-32,0.97,62.0723,62.5447,63.0423,63.5147,61.5747,61.1023,60.6047,0.461030928,-409639482,150624512.3,-1
4/12/2013,62.0214,62.0214,61.2985,61.3999,59651011,AAPL,61.35169,3.077858603,-0.1271,-53.68852459,-79.86882781,-0.872446538,-53.76497682,-42916711.61,-11580128.16,48,80,-32,0.7486,61.57326667,61.84803333,62.29616667,62.57093333,61.12513333,60.85036667,60.40223333,0.140268364,-469290493,150002305.4,-1
4/15/2013,60.9999,61.1271,59.9357,59.9785,79157071,AAPL,61.22226,2.994277899,1.4203,-35.60532087,-99.4055473,-1.362529939,-95.23805986,-73469774.31,-14788820.5,44,76,-32,1.4642,60.3471,60.7585,61.5385,61.9499,59.5671,59.1557,58.3757,0.035924123,-548447564,148169829.1,-1
4/16/2013,60.2242,60.9442,60.0814,60.8914,76222076,AAPL,61.17152,2.919294836,0.8214,-62.93153598,-85.54772562,-1.67146259,-80.41627487,66893087.56,-10580883.02,40,96,-56,0.9657,60.639,61.1966,61.5018,62.0594,60.3338,59.7762,59.471,0.938803894,-472225488,149329963.7,1
4/17/2013,60.0385,60.0857,56.8728,57.5428,236138966,AAPL,60.75452,2.829430548,3.56,-44.5625,-92.00887373,-1.757625439,-164.8026091,-137652796.4,-17087697.11,36,92,-56,4.0186,58.1671,59.4614,61.38,62.6743,56.2485,54.9542,53.0356,0.208534346,-708364454,136343976.5,-1
4/18/2013,57.8557,57.9699,55.6774,56.0071,166438048,AAPL,60.24495,2.738968184,4.45,-43.39142462,-96.28217995,-2.000140785,-190.0431164,-118564875.1,-22254199.61,32,96,-64,2.2925,56.55146667,57.42553333,58.84396667,59.71803333,55.13303333,54.25896667,52.84053333,0.143816794,-874802502,131902084.4,-1
4/19/2013,55.4242,57.0857,55.0142,55.7899,152194413,AAPL,59.77823,2.65467192,5.0972,-57.21789564,-90.73370604,-2.319821835,-164.5195538,-38212075.4,-23062251.47,28,96,-68,2.0715,55.96326667,56.91233333,58.03476667,58.98383333,54.84083333,53.89176667,52.76933333,0.37446295,-1026996915,131311862.3,-1
4/22/2013,56.0914,57.4571,55.8964,56.9528,107338322,AAPL,59.3848,2.578562908,4.0443,-93.88439046,-74.41535132,-2.518142569,-112.7174416,37971094.75,-19987665.59,24,96,-72,1.6672,56.76876667,57.64113333,58.32946667,59.20183333,56.08043333,55.20806667,54.51973333,0.676875761,-919658593,133549251.8,1
4/23/2013,57.7128,58.3401,56.9728,58.0185,160760747,AAPL,59.08694,2.510708571,4.2229,-133.3351379,-60.23796604,-2.518494552,-70.41131854,85136295.55,-14717924.75,20,92,-72,1.3873,57.77713333,58.58146667,59.14443333,59.94876667,57.21416667,56.40983333,55.84686667,0.764791926,-758897846,136557404.6,1
4/24/2013,56.2199,59.3214,56.0714,57.9231,242387530,AAPL,58.65511,2.440965336,4.124,-154.9139856,-61.50058896,-2.482393882,-58.30289934,33814924.95,-12296349.06,16,88,-72,3.25,57.77196667,59.47253333,61.02196667,62.72253333,56.22253333,54.52196667,52.97253333,0.569753846,-1001285376,136158846.1,-1
4/25/2013,58.7464,59.1342,58.1428,58.3399,95984896,AAPL,58.28439,2.377002475,3.06,-252.3427168,-55.98422383,-2.473486644,-33.24167642,-57819426.96,-14557707.56,12,84,-72,1.2111,58.53896667,58.93513333,59.53036667,59.92653333,57.94373333,57.54756667,56.95233333,0.198809764,-905300480,136849529.2,1
4/26/2013,58.5442,59.8241,58.3214,59.6007,191006032,AAPL,58.10447,2.323687402,0.3778,-479.8973881,-39.29748402,-2.64524359,-12.83605418,134213927.7,-7198536.847,8,80,-72,1.5027,59.24873333,60.17606667,60.75143333,61.67876667,58.67336667,57.74603333,57.17066667,0.851334265,-714294448,140977414.3,1
4/29/2013,60.0642,61.9452,59.9999,61.4457,159958876,AAPL,58.25119,2.285412469,-0.5543,1762.906821,-14.8788332,-2.763877915,33.21075102,77812720.07,-3010153.592,4,76,-72,2.3445,61.13026667,62.26063333,63.07556667,64.20593333,60.31533333,59.18496667,58.37003333,0.743227266,-554335572,145929103.2,1
4/30/2013,62.1571,63.6071,61.7242,63.2542,172737600,AAPL,58.48747,2.25288118,-5.7114,836.5521327,-4.106878935,-2.68201245,75.48760617,107987375.3,2437757.703,0,72,-72,2.1614,62.86183333,63.99946667,64.74473333,65.88236667,62.11656667,60.97893333,60.23366667,0.812576345,-381597972,151013201,1
5/1/2013,63.4942,63.5614,62.0557,62.7557,126720237,AAPL,59.00876,2.230596746,-6.7486,1195.681626,-9.908180009,-2.399664832,69.33499629,-8895748.855,1883503.806,0,68,-68,1.5057,62.79093333,63.52616667,64.29663333,65.03186667,62.02046667,61.28523333,60.51476667,0.464900046,-508318209,150014531.6,-1
5/2/2013,63.1114,64.0842,62.9471,63.6457,105449078,AAPL,59.77262,2.217434556,-7.8558,416.8937572,-4.834619625,-2.235468272,81.12093076,24120398.55,2967238.784,0,64,-64,1.3285,63.559,64.1709,64.6961,65.308,63.0338,62.4219,61.8967,0.614369888,-402869131,151510008.1,1
5/3/2013,64.4728,64.7471,64.1642,64.2828,90319201,AAPL,60.62191,2.20746644,-7.33,232.3188439,-4.770417861,-1.654456331,91.12919324,-53565530.6,221074.7702,0,60,-60,1.1014,64.39803333,64.63186667,64.98093333,65.21476667,64.04896667,63.81513333,63.46606667,0.203465431,-312549930,152414112.6,1
5/6/2013,65.1014,66.0285,64.9014,65.8156,124017747,AAPL,61.50819,2.199504507,-7.7971,215.6614272,-1.932941721,-0.852251245,107.6301143,77165864.58,3947150.637,96,56,40,1.7457,65.58183333,66.26226667,66.70893333,67.38936667,65.13516667,64.45473333,64.00806667,0.811108154,-188532183,155371270.7,1
5/7/2013,66.4242,66.5356,64.8142,65.5225,120499960,AAPL,62.25859,2.186800347,-7.5994,133.0826973,-8.793202215,-0.07684481,97.06758971,-21336347.05,2726415.762,96,52,44,1.7214,65.6241,66.434,67.3455,68.1554,64.7126,63.9027,62.9912,0.41146741,-309032143,154834642,-1
5/8/2013,65.5771,66.4814,65.1156,66.2628,118010781,AAPL,63.09256,2.177149686,-7.9229,110.7666956,-2.367767806,0.63634001,98.13170193,80234888.88,6458119.999,96,48,48,1.3658,65.95326667,66.79093333,67.31906667,68.15673333,65.42513333,64.58746667,64.05933333,0.839947284,-191021362,156167976.1,1
5/9/2013,65.6871,66.1428,65.0828,65.2528,99555337,AAPL,63.78385,2.162408895,-5.6521,120.0467087,-11.13406357,1.262581583,86.70899466,-67622493.06,2901025.585,92,44,48,1.18,65.4928,65.9028,66.5528,66.9628,64.8428,64.4328,63.7828,0.160377358,-290576699,154650520,-1
5/10/2013,65.4242,65.6728,64.3542,64.7099,83631828,AAPL,64.29477,2.142065538,-3.2642,131.4537649,-17.16012482,1.911609146,74.01737052,-38511486.4,917621.6796,88,40,48,1.3186,64.9123,65.4704,66.2309,66.789,64.1518,63.5937,62.8332,0.269755802,-374208527,153954707.4,-1
5/13/2013,64.5014,65.4142,64.4999,64.9628,79220953,AAPL,64.64648,2.117558983,-1.7086,135.1352908,-15.03029376,2.532007399,71.41933434,996435.4801,921387.1894,84,36,48,0.9143,64.95896667,65.41803333,65.87326667,66.33233333,64.50373333,64.04466667,63.58943333,0.506288964,-294987574,154264319.7,1
5/14/2013,64.8356,65.0285,63.1642,63.4085,111647130,AAPL,64.66191,2.083017324,-0.6528,171.0759471,-29.88379427,3.023989693,45.47451514,-82386395.29,-3049609.269,80,32,48,1.8643,63.86706667,64.56993333,65.73136667,66.43423333,62.70563333,62.00276667,60.84133333,0.131041141,-406634704,151593050.4,-1
5/15/2013,62.7371,62.9999,60.3371,61.2642,185278968,AAPL,64.51276,2.043754681,2.3815,306.6511644,-62.80859785,3.253070264,-4.643660579,-56262796.13,-5580501.1,76,28,48,3.0714,61.53373333,62.73036667,64.19653333,65.39316667,60.06756667,58.87093333,57.40476667,0.348167343,-591913672,145327428.4,-1
5/16/2013,60.4628,62.5499,59.8428,62.0825,150794546,AAPL,64.35644,2.006042825,2.2003,343.4966557,-54.21221787,3.344726441,-10.7570942,98723051.93,-630111.269,72,24,48,2.7071,61.49173333,63.14066667,64.19883333,65.84776667,60.43356667,58.78463333,57.72646667,0.827342913,-441119126,147341576.6,1
5/17/2013,62.7214,62.8699,61.5728,61.8942,106973181,AAPL,64.11758,1.967191252,3.9214,1489.386845,-69.34915133,3.496420715,-4.276807887,-53960798.96,-3156189.524,68,20,48,1.2971,62.1123,62.6518,63.4094,63.9489,61.3547,60.8152,60.0576,0.247783517,-548092307,147017120.4,-1
5/20/2013,61.7014,63.6857,61.4428,63.2757,112681030,AAPL,63.86359,1.929872053,2.2468,29083.25581,-48.70756634,3.527157047,3.851711612,71485058.45,372545.3484,64,16,48,2.2429,62.8014,64.16,65.0443,66.4029,61.9171,60.5585,59.6742,0.817200945,-435411277,149532200.1,1
5/21/2013,62.5928,63.6399,62.0285,62.8085,113921367,AAPL,63.59219,1.89309634,3.4543,11842.61364,-55.68820225,3.368836046,-1.071831775,-3633832.856,183484.4221,60,12,48,1.6114,62.82563333,63.62276667,64.43703333,65.23416667,62.01136667,61.21423333,60.39996667,0.484051136,-549332644,148691054.7,-1
5/22/2013,63.4357,64.0499,62.6028,63.0505,110727309,AAPL,63.27096,1.856284092,2.2023,-941.6834677,-52.07237628,3.045121138,2.166086148,-42214260.5,-1813798.351,56,8,48,1.4471,63.2344,63.866,64.6815,65.3131,62.4189,61.7873,60.9718,0.309377375,-438605335,149117685,1
5/23/2013,62.2785,63.7371,62.2557,63.1628,88244695,AAPL,63.06196,1.823699776,1.5471,-453.5803571,-50.39445374,2.526981203,-8.607720444,19824378.63,-796144.9848,52,4,48,1.4814,63.05186667,63.84803333,64.53326667,65.32943333,62.36663333,61.57046667,60.88523333,0.612326178,-350360640,149274858.7,1
5/24/2013,62.9785,63.6657,62.9085,63.5928,69036716,AAPL,62.95025,1.794857202,1.37,-178.9319777,-43.96963902,1.782198448,-5.750098329,55743592.4,1858760.842,48,0,48,0.7572,63.389,63.8695,64.1462,64.6267,63.1123,62.6318,62.3551,0.903724247,-281323924,149744847.1,1
5/28/2013,64.2714,64.4442,62.9785,63.0627,96404189,AAPL,62.76024,1.764623796,0.3458,-161.6920075,-51.89009084,1.104849649,-7.296179003,-85327935.04,-2229078.039,44,0,44,1.4657,63.49513333,64.01176667,64.96083333,65.47746667,62.54606667,62.02943333,61.08036667,0.057446954,-377728113,148941236.3,-1
5/29/2013,62.8571,63.9285,62.7714,63.5642,82641944,AAPL,62.77581,1.740751425,-2.3,-138.5347958,-43.94300003,0.5491297,-13.46342064,30604159.54,-691858.0811,40,4,36,1.1571,63.42136667,64.07133333,64.57846667,65.22843333,62.91423333,62.26426667,61.75713333,0.685161179,-295086169,149598438.4,1
5/30/2013,63.6642,64.9285,63.5014,64.5114,88379522,AAPL,63.10053,1.725692285,-2.4289,-632.0070138,-25.8952381,0.015458702,29.46289246,36717972.53,1057246.864,36,0,36,1.4271,64.31376667,65.12613333,65.74086667,66.55323333,63.69903333,62.88666667,62.27193333,0.707728961,-206706647,150915423.1,1
5/31/2013,64.6428,65.2999,64.2142,64.2478,95832240,AAPL,63.31706,1.708129804,-2.3536,-1014.001298,-24.44253859,-0.341355578,55.75320672,-89900650.68,-3189985.576,32,0,32,1.0857,64.5873,64.9604,65.673,66.0461,63.8747,63.5016,62.789,0.030947776,-302538887,150523843.1,-1
6/3/2013,64.3899,64.6228,63.2114,64.3885,92926932,AAPL,63.56649,1.691823911,-1.1128,-796.360787,-18.41009441,-0.376425504,23.81875164,62074189.8,-146282.3494,28,0,28,1.4114,64.07423333,64.93706667,65.48563333,66.34846667,63.52566667,62.66283333,62.11426667,0.833994615,-209611955,150727349.2,1
6/4/2013,64.7456,64.9185,63.9128,64.1871,72860221,AAPL,63.65763,1.67194361,-1.3786,587.4004624,-20.39178318,-0.439763363,87.31574386,-33115647.83,-1682048.02,24,52,-28,1.0057,64.33946667,64.76613333,65.34516667,65.77183333,63.76043333,63.33376667,62.75473333,0.272745351,-282472176,150499450.6,-1
6/5/2013,63.6642,64.3885,63.3871,63.5871,72545760,AAPL,63.73549,1.652028797,-0.5366,196.8875113,-31.38663393,-0.367062455,22.67350323,-43568024.83,-3630967.148,20,48,-28,1.0014,63.78756667,64.18803333,64.78896667,65.18943333,63.18663333,62.78616667,62.18523333,0.199720391,-355017936,149821316.6,-1
6/6/2013,63.6385,63.8571,62.0071,62.6371,104230322,AAPL,63.69415,1.629460185,0.5257,677.1006131,-48.79514761,-0.388167146,-153.372539,-33241021.61,-5007219.043,16,44,-28,1.85,62.83376667,63.66043333,64.68376667,65.51043333,61.81043333,60.98376667,59.96043333,0.340540541,-459248258,148264101.3,-1
6/7/2013,62.3571,63.3199,61.8242,63.1158,101120551,AAPL,63.68945,1.608501393,0.477,346.586444,-56.62544399,-0.362836534,-135.3032743,73523165.88,-1360925.132,12,40,-28,1.4957,62.7533,63.6824,64.249,65.1781,62.1867,61.2576,60.691,0.863542154,-358127707,149036908.5,1
6/10/2013,63.5328,64.1541,62.3999,62.6985,112522179,AAPL,63.60002,1.585977415,0.3642,-494.1787942,-67.44445309,-0.321468695,-41.4023635,-74215118.63,-4740362.211,8,36,-28,1.7542,63.08416667,63.76843333,64.83836667,65.52263333,62.01423333,61.32996667,60.26003333,0.170220043,-470649886,148292950.5,-1
6/11/2013,62.2485,63.2514,61.9028,62.5142,71526560,AAPL,63.54517,1.564780741,1.05,-969.2150866,-80.14788388,-0.257336871,-119.6402689,-6672134.99,-4829886.603,4,32,-28,1.3486,62.55613333,63.20946667,63.90473333,64.55806667,61.86086667,61.20753333,60.51226667,0.453359039,-542176446,148082700.8,-1
6/12/2013,62.7857,63.0357,61.6428,61.7414,66295887,AAPL,63.36289,1.541003607,2.77,-199.4041708,-97.30387465,-0.174897188,-163.7293999,-56910038.11,-7241300.964,0,28,-28,1.3929,62.13996667,62.63713333,63.53286667,64.03003333,61.24423333,60.74706667,59.85133333,0.070787566,-608472333,147263151.6,-1
6/13/2013,61.7857,62.4485,61.2499,62.2807,71456693,AAPL,63.13982,1.517102532,1.9671,-344.3373767,-74.54814815,-0.022498453,-166.4822862,51449295.89,-4526110.824,0,24,-24,1.1986,61.99303333,62.73616667,63.19163333,63.93476667,61.53756667,60.79443333,60.33896667,0.860003337,-537015640,147887312.9,1
6/14/2013,62.1999,62.3271,61.2142,61.4357,67962419,AAPL,62.85861,1.492304711,2.9528,-120.8752492,-94.57865237,0.089436814,-192.7422628,-40909357.97,-6207941.651,0,20,-20,1.1129,61.659,62.1038,62.7719,63.2167,60.9909,60.5461,59.878,0.199029562,-604978059,146965225.6,-1
6/17/2013,61.6342,62.2428,61.4802,61.7142,64818670,AAPL,62.59118,1.468551233,2.4729,-214.0081572,-87.76219497,0.00783068,-144.5764583,-25040099.9,-7077795.501,0,16,-16,0.8071,61.8124,62.1446,62.575,62.9072,61.382,61.0498,60.6194,0.306845004,-540159389,147259061.3,1
6/18/2013,61.6514,62.1285,61.4585,61.6814,48753768,AAPL,62.34061,1.445779471,1.9057,-126.6411727,-88.56499498,-0.087456959,-128.2496411,-16314320.58,-7504115.399,0,12,-12,0.67,61.75613333,62.05376667,62.42613333,62.72376667,61.38376667,61.08613333,60.71376667,0.332686567,-588913157,147233149.5,-1
6/19/2013,61.6285,61.6657,60.4285,60.4285,77715057,AAPL,62.02475,1.421862163,2.2086,-35.20047025,-100,-0.235475838,-188.9012179,-77715057,-10742491.69,48,8,40,1.2529,60.8409,61.2533,62.0781,62.4905,60.0161,59.6037,58.7789,0,-666628214,145654566.7,-1
6/20/2013,59.8999,60.8542,59.3099,59.5482,89327210,AAPL,61.71586,1.398492888,3.5676,-30.58132607,-96.02170284,-0.499344853,-223.4343387,-61759154.39,-13093987.02,44,4,40,1.5443,59.9041,60.4983,61.4484,62.0426,58.954,58.3598,57.4097,0.154309396,-755955424,144353281,-1
6/21/2013,59.7842,59.9999,58.3,59.0714,120286768,AAPL,61.31142,1.373603389,3.6271,-24.38359256,-88.34479112,-0.855920181,-227.975136,-11116566.42,-13002900.5,40,96,-56,1.6999,59.12376667,59.94753333,60.82366667,61.64743333,58.24763333,57.42386667,56.54773333,0.453791399,-876242192,143390149.8,-1
6/24/2013,58.1999,58.3799,56.8642,57.5057,120104964,AAPL,60.79214,1.346593773,5.0085,-19.4046158,-92.03531033,-1.098450112,-252.6492529,-18439285.56,-13253165.97,36,96,-60,2.2072,57.58326667,58.30233333,59.09896667,59.81803333,56.78663333,56.06756667,55.27093333,0.423236788,-996347156,140206742.2,-1
6/25/2013,57.9571,58.2557,56.9757,57.5185,78534687,AAPL,60.29257,1.320718849,4.2229,-21.57499258,-91.30417447,-1.448274506,-191.2551126,-11927455.59,-13192171.96,32,96,-64,1.28,57.5833,58.1909,58.8633,59.4709,56.9109,56.3033,55.6309,0.4240625,-917812469,140224223,1
6/26/2013,57.6999,57.8271,56.5228,56.8671,91924994,AAPL,59.80514,1.295621645,5.4136,-22.6915078,-95.48831785,-1.704771599,-166.3460387,-43393558.85,-14580924.73,28,92,-64,1.3043,57.07233333,57.62186667,58.37663333,58.92616667,56.31756667,55.76803333,55.01326667,0.263973012,-1009737463,139183167.7,-1
6/27/2013,57.0357,57.3414,56.2199,56.2542,84297955,AAPL,59.20249,1.268715023,5.1815,-12.10504839,-99.56769429,-2.013823724,-147.0171956,-79141611.07,-17548055.68,24,96,-72,1.1215,56.60516667,56.99043333,57.72666667,58.11193333,55.86893333,55.48366667,54.74743333,0.030584039,-1094035418,138274624.5,-1
6/28/2013,55.9085,57.1814,55.5528,56.6471,144619734,AAPL,58.72363,1.245081512,5.0671,-20.21846184,-87.27750456,-2.224869049,-122.1901078,49728018.57,-14457687.09,20,96,-76,1.6286,56.46043333,57.36806667,58.08903333,58.99666667,55.73946667,54.83183333,54.11086667,0.671926808,-949415684,139284701.8,1
7/1/2013,57.5271,58.8957,57.3171,58.4599,97743408,AAPL,58.3982,1.225489607,3.2215,-74.89085662,-62.23858883,-2.488839369,-58.30496041,43775870.68,-11783978.43,16,96,-80,2.2486,58.22423333,59.13136667,59.80283333,60.70996667,57.55276667,56.64563333,55.97416667,0.723932599,-851672276,142412651,1
7/2/2013,58.5657,60.2328,58.4957,59.7842,117442150,AAPL,58.20848,1.209316207,0.6443,-222.7978745,-43.45240482,-2.603526439,-20.11800276,56784100.96,-8637219.655,12,92,-80,1.7729,59.50423333,60.51276667,61.24133333,62.24986667,58.77566667,57.76713333,57.03856667,0.741753497,-734230126,145073083.9,1
7/3/2013,60.1228,60.4257,59.6357,60.1142,60232158,AAPL,58.17705,1.196646782,-0.566,-191.613201,-33.85153066,-2.802211045,-2.788466714,12732620.74,-7656934.113,8,88,-80,0.79,60.05853333,60.48136667,60.84853333,61.27136667,59.69136667,59.26853333,58.90136667,0.605696203,-673997968,145405556.5,1
7/5/2013,60.0557,60.4699,59.3357,59.6314,68505794,AAPL,58.18537,1.184896866,-0.56,-230.0781466,-39.79304135,-3.002269604,-5.149635164,-32785174.56,-8809144.989,4,84,-80,1.1342,59.81233333,60.28896667,60.94653333,61.42316667,59.15476667,58.67813333,58.02056667,0.260712396,-742503762,144855360.5,-1
7/8/2013,60.0157,60.1428,58.6642,59.2928,74521398,AAPL,58.20751,1.173571064,-1.7871,-159.9405303,-44.09566517,-2.999690334,-12.19355847,-11158553.71,-8916830.025,0,80,-80,1.4786,59.3666,60.069,60.8452,61.5476,58.5904,57.888,57.1118,0.425131882,-817025160,144432211.8,-1
7/9/2013,59.0857,60.4999,58.6257,60.3357,88142026,AAPL,58.49051,1.167589586,-2.8172,-365.2894404,-27.26401752,-2.873354982,3.217275719,72697654.35,-5177456.531,4,76,-72,1.8742,59.82043333,61.01516667,61.69463333,62.88936667,59.14096667,57.94623333,57.26676667,0.912389286,-728883134,145982540.3,1
7/10/2013,59.9428,60.6857,59.7499,60.1042,70107226,AAPL,58.74908,1.16116773,-3.2371,-1515.787851,-25.54434066,-2.675065165,15.87764603,-17021117.49,-5719906.839,0,72,-72,0.9358,60.17993333,60.60996667,61.11573333,61.54576667,59.67416667,59.24413333,58.73836667,0.37860654,-798990360,145713548.3,-1
7/11/2013,60.4214,61.1785,60.1671,61.0411,81571665,AAPL,59.16648,1.157940632,-4.7869,392.028937,-2.442362728,-2.234565351,35.29989554,59408432.31,-2738003.207,0,68,-68,1.0743,60.79556667,61.42403333,61.80696667,62.43543333,60.41263333,59.78416667,59.40123333,0.864148705,-717418695,146985081.6,1
7/12/2013,61.0928,61.3985,60.4871,60.9299,69882694,AAPL,59.63405,1.15559658,-4.2828,314.9098736,-8.016148622,-1.805931285,42.66527053,-1978246.111,-2703229.19,8,64,-56,0.9114,60.9385,61.3899,61.8499,62.3013,60.4785,60.0271,59.5671,0.485845951,-787301389,146857774.7,-1
7/15/2013,60.7157,61.6371,60.6857,61.0628,60478033,AAPL,60.07562,1.152766891,-2.6029,168.2690956,-9.439048042,-1.309428219,52.08100566,-12535493.07,-3153109.181,4,60,-56,0.9514,61.12853333,61.57136667,62.07993333,62.52276667,60.61996667,60.17713333,59.66856667,0.396363254,-726823356,146989689.1,1
7/16/2013,60.9314,61.5299,60.5957,61.4564,54033805,AAPL,60.37527,1.147431911,-1.6722,161.6673862,-2.969939023,-0.644176426,61.08893362,45531375.83,-926197.1812,0,56,-56,0.9342,61.194,61.7923,62.1282,62.7265,60.8581,60.2598,59.9239,0.921323057,-672789551,147337981.4,1
7/17/2013,61.3857,61.7457,61.1742,61.4728,49743169,AAPL,60.54413,1.139815237,-1.3586,138.5826259,-4.406659239,-0.005994109,78.26843576,2236919.411,-781552.3312,0,52,-52,0.5715,61.46423333,61.75426667,62.03573333,62.32576667,61.18276667,60.89273333,60.61126667,0.522484689,-623046382,147351255.7,1
7/18/2013,61.9114,62.1242,61.5157,61.6797,54696012,AAPL,60.70068,1.132129825,-2.0483,121.456087,-6.764159844,0.419805477,98.16721369,-25213198.63,-1898470.896,0,48,-48,0.6514,61.7732,62.0307,62.3817,62.6392,61.4222,61.1647,60.8137,0.269515201,-568350370,147535346.9,1
7/19/2013,61.8714,61.9971,60.6214,60.7071,67174828,AAPL,60.80825,1.123533774,-1.4143,152.6280788,-21.56465898,0.616000708,75.81909734,-58805441.13,-4499353.097,0,44,-44,1.3757,61.10853333,61.59566667,62.48423333,62.97136667,60.21996667,59.73283333,58.84426667,0.062295559,-635525198,146476096.7,-1
7/22/2013,61.3514,61.3928,60.7811,60.9014,51946202,AAPL,60.96911,1.116038256,-0.5657,187.5158714,-25.43737388,0.81740127,78.57441307,-31514199.06,-5733734.429,0,40,-40,0.6857,61.0251,61.2691,61.6368,61.8808,60.6574,60.4134,60.0457,0.196665032,-583578996,146642356.4,1
7/23/2013,60.8571,60.9942,59.8157,59.8557,91062300,AAPL,60.92111,1.10488422,0.2485,4550.909091,-62.51894722,1.019749184,29.15716738,-84880726.81,-9349313.362,0,36,-36,1.1785,60.22186667,60.62803333,61.40036667,61.80653333,59.44953333,59.04336667,58.27103333,0.033941451,-674641296,145078782.4,-1
7/24/2013,62.7042,63.5128,62.1799,62.9299,147978789,AAPL,61.20368,1.100087546,-1.8888,213.0234045,-11.92731886,1.381139269,170.7630666,18551470.96,-8075044.272,0,32,-32,3.6571,62.8742,63.5685,64.2071,64.9014,62.2356,61.5413,60.9027,0.562682872,-526662507,152679000.8,1
7/25/2013,62.9571,63.0571,62.2585,62.6428,57371671,AAPL,61.36385,1.093211766,-1.7129,199.1797835,-17.80196845,1.614800066,120.1445167,-2155209.279,-7804735.493,96,28,68,0.7986,62.6528,63.0471,63.4514,63.8457,62.2485,61.8542,61.4499,0.48121713,-584034178,152417258.7,-1
7/26/2013,62.1857,63.0057,62.0485,62.9985,50031170,AAPL,61.57071,1.087271119,-1.9357,171.460183,-10.52362342,1.83043039,95.28961298,49278507.18,-5198766.175,92,24,68,0.9572,62.68423333,63.31996667,63.64143333,64.27716667,62.36276667,61.72703333,61.40556667,0.992478061,-534003008,152701347,1
7/29/2013,62.9714,64.2842,62.8857,63.9699,62021344,AAPL,61.86142,1.08294783,-2.5135,172.8661053,-5.554475568,1.902879998,116.1308877,34143891.85,-3403046.354,88,20,68,1.3985,63.71326667,64.54083333,65.11176667,65.93933333,63.14233333,62.31476667,61.74383333,0.775259206,-471981664,153657679.8,1
7/30/2013,64.2799,65.3071,64.1757,64.7599,77257432,AAPL,62.19177,1.079428212,-3.2871,151.9062654,-9.846685381,1.993749012,130.1837568,2526537.903,-3132452.92,96,16,80,1.3372,64.74756667,65.31943333,65.87896667,66.45083333,64.18803333,63.61616667,63.05663333,0.516351423,-394724232,154611775,1
7/31/2013,64.9985,65.3346,64.2042,64.6471,80637830,AAPL,62.5092,1.075689167,-2.9674,170.1442041,-12.45719256,1.980567866,107.3636902,-17448702.42,-3785649.85,96,12,84,1.1304,64.72863333,65.25306667,65.85903333,66.38346667,64.12266667,63.59823333,62.99226667,0.391808209,-475362062,154471318.5,-1
8/1/2013,65.1075,65.2571,64.7514,65.2394,51461179,AAPL,62.86517,1.072678962,-4.5323,156.1132382,-1.724981427,1.939487763,103.6511141,47858794.71,-1429711.516,96,8,88,0.61,65.08263333,65.41386667,65.58833333,65.91956667,64.90816667,64.57693333,64.40246667,0.964999011,-423900883,154942808.4,1
8/2/2013,65.4299,66.1214,65.2371,66.0771,68467077,AAPL,63.40217,1.072705054,-5.1757,148.2260734,-0.702538973,1.887554254,110.2938149,61607207.02,1445462.375,92,4,88,0.8843,65.81186667,66.38663333,66.69616667,67.27093333,65.50233333,64.92756667,64.61803333,0.949903879,-355433806,155821953.1,1
8/5/2013,66.3842,67.2385,66.0214,67.0642,79589930,AAPL,64.01845,1.074061631,-7.2085,143.12208,-2.348170502,1.806581695,119.9903422,56793898.78,3969562.487,96,0,96,1.2171,66.7747,67.528,67.9918,68.7451,66.3109,65.5576,65.0938,0.856790732,-275843876,157010916,1
8/6/2013,66.8599,67.4128,66.0242,66.4642,83715443,AAPL,64.6793,1.075933038,-3.5343,160.468005,-12.48634347,1.889398972,99.19768246,-30662303.26,2390452.847,96,0,96,1.3886,66.63373333,67.24326667,68.02233333,68.63186667,65.85466667,65.24513333,64.46606667,0.316865908,-359559319,156261943.1,-1
8/7/2013,66.2571,66.7142,65.9671,66.4256,74663176,AAPL,65.02887,1.072782548,-3.7828,164.4092796,-12.99443209,2.087348553,80.49094178,16979351.63,3055568.3,96,0,96,0.7471,66.36896667,66.77083333,67.11606667,67.51793333,66.02373333,65.62186667,65.27663333,0.613706331,-434222495,156218581.4,-1
8/8/2013,66.2649,66.2999,65.4214,65.8585,63946841,AAPL,65.35044,1.069123828,-2.86,151.4675622,-20.45912256,2.539222084,60.31339959,-313001.043,2902014.358,92,12,80,1.0042,65.85993333,66.29846667,66.73843333,67.17696667,65.41996667,64.98143333,64.54146667,0.497552647,-498169336,155672643.5,-1
8/12/2013,65.2656,66.9499,65.2328,66.7656,91008477,AAPL,65.8223,1.059244306,-2.0057,136.7979276,-8.51904016,2.738737679,58.34424977,71472209.68,3678579.255,84,4,80,2.0285,66.3161,67.3994,68.0332,69.1165,65.6823,64.599,63.9652,0.89266787,-473933845,157307778,1
8/13/2013,67.2771,70.6656,66.8642,69.9385,219634975,AAPL,66.34016,1.059204296,-5.2914,136.2797135,-8.437873531,2.912441968,109.7228127,135615092.7,9690579.645,80,0,80,3.9,69.1561,71.448,72.9575,75.2494,67.6466,65.3547,63.8452,0.808728363,-254298870,167745485.6,1
8/14/2013,71.1256,72.0356,70.4856,71.2142,188602792,AAPL,66.99687,1.061360534,-5.9748,126.3154211,-8.224609747,3.082060533,138.4449554,-11291831.68,8734574.135,96,0,96,2.0971,71.24513333,72.00466667,72.79513333,73.55466667,70.45466667,69.69513333,68.90466667,0.470064516,-65696078,171185659.2,1
8/16/2013,71.4499,71.8485,71.2656,71.7614,90461889,AAPL,68.15435,1.063063478,-4.6972,130.0314445,-2.996754063,3.349491287,106.8061325,63427301.48,12580360.37,92,28,64,0.7186,71.62516667,71.98473333,72.20806667,72.56763333,71.40183333,71.04226667,70.81893333,0.850574713,-97676082,171843850.1,1
1/2/2014,79.3828,79.5756,78.8601,79.0185,58791957,AAPL,79.63806,0.713037313,-0.3372,-427.7026452,-56.68154982,0.221286196,-44.81929941,-32760801.2,-2785424.828,28,0,28,1.2855,79.1514,79.4427,79.8669,80.1582,78.7272,78.4359,78.0117,0.221383648,264357555,177095714.1,-1
1/3/2014,78.9799,79.0999,77.2042,77.2828,98303870,AAPL,79.49821,0.708548137,0.4971,-179.9556239,-93.41050003,-0.141880491,-123.2263713,-90152069.42,-6756734.248,24,0,24,1.8957,77.8623,78.5204,79.758,80.4161,76.6247,75.9666,74.729,0.041462257,166053685,174936396.6,-1
1/6/2014,76.7785,78.1142,76.2285,77.7042,103359151,AAPL,79.49064,0.705266608,0.7272,-363.3266667,-73.01503127,-0.37731067,-148.8882949,58413240.29,-3794392.684,20,0,20,1.8857,77.34896667,78.46943333,79.23466667,80.35513333,76.58373333,75.46326667,74.69803333,0.78257411,269412836,175499983.1,1
1/7/2014,77.7599,77.9942,76.8464,77.1481,79432766,AAPL,79.36231,0.700952408,4.2932,-200.8778611,-83.1839959,-0.44063036,-134.8518584,-37674854.34,-5334448.403,16,96,-80,1.1478,77.32956667,77.81273333,78.47736667,78.96053333,76.66493333,76.18176667,75.51713333,0.262850671,189980070,174931512.4,-1
1/8/2014,76.9728,77.9371,76.9556,77.6371,64686685,AAPL,78.98189,0.694537316,3.4585,-333.9384373,-74.24203635,-0.274236397,-109.6446768,25143118.01,-3949074.649,12,92,-80,0.9815,77.50993333,78.06426667,78.49143333,79.04576667,77.08276667,76.52843333,76.10126667,0.69434539,254666755,175341526.3,1
1/9/2014,78.1142,78.1228,76.4785,76.6455,69905199,AAPL,78.53688,0.68760285,3.9116,-270.1787995,-92.37464799,-0.256109733,-118.7476115,-55705639.03,-6301694.104,8,88,-80,1.6443,77.08226667,77.68603333,78.72656667,79.33033333,76.04173333,75.43796667,74.39743333,0.101562975,184761556,174448680,-1
1/10/2014,77.1185,77.2571,75.8728,76.1342,76320664,AAPL,78.09459,0.680749457,3.8786,-334.2225193,-95.51190701,-0.545093014,-131.3778921,-47497111.92,-8174249.828,4,84,-80,1.3843,76.42136667,76.96993333,77.80566667,78.35423333,75.58563333,75.03706667,74.20133333,0.188831901,108440892,173939547,-1
1/13/2014,75.7014,77.4999,75.6971,76.5328,94860843,AAPL,77.74659,0.674786291,2.6843,-276.3825977,-86.07166667,-0.822073509,-103.3886929,-6914086.294,-8116968.595,0,96,-96,1.8028,76.5766,77.4561,78.3794,79.2589,75.6533,74.7738,73.8505,0.46355669,203301735,174436190.2,1
1/14/2014,76.8885,78.1042,76.8085,78.0556,83734371,AAPL,77.63044,0.670900871,2.09,-111.0641817,-60.69166667,-0.990373416,-44.08419204,77452839.12,-4227362.361,48,96,-48,1.5714,77.6561,78.5037,78.9518,79.7994,77.208,76.3604,75.9123,0.962491317,287036106,176102282.3,1
1/15/2014,79.0742,80.0285,78.8085,79.6228,98472619,AAPL,77.57816,0.667647798,-0.6043,-361.7259641,-34.57166667,-1.134777151,38.52925562,32980255.84,-2536078.133,44,92,-48,1.9729,79.4866,80.1647,80.7066,81.3847,78.9447,78.2666,77.7247,0.667459016,385508725,178079415.2,1
1/16/2014,79.2713,79.5499,78.8113,79.1785,57471330,AAPL,77.59416,0.664978713,-1.8957,-386.442768,-38.49116608,-1.134617176,25.99598416,-326806.9131,-2435655.079,40,88,-48,0.8115,79.1799,79.5485,79.9185,80.2871,78.8099,78.4413,78.0713,0.497156783,328037395,177758721.7,-1
1/17/2014,78.7828,78.8671,77.1285,77.2385,108426689,AAPL,77.58973,0.662090256,0.4657,-192.0304221,-68.75202725,-1.331357818,-41.96596007,-94706528.19,-6629850.874,36,84,-48,2.05,77.7447,78.3609,79.4833,80.0995,76.6223,76.0061,74.8837,0.063269297,219610706,175102094.2,-1
1/21/2014,77.2842,78.5813,77.2028,78.4385,82255544,AAPL,77.66316,0.659916118,-1.2904,-838.3637298,-38.88579263,-1.400061435,-25.27293149,65213698.98,-3364186.514,32,80,-48,1.3785,78.0742,78.9456,79.4527,80.3241,77.5671,76.6957,76.1886,0.89640914,301866250,176380040.5,1
1/22/2014,78.702,79.6128,78.2585,78.7871,95219334,AAPL,77.82706,0.658517683,-1.15,-437.8064041,-31.1144303,-1.229738818,11.46075477,-20888772.16,-4160769.872,28,76,-48,1.3543,78.88613333,79.51376667,80.24043333,80.86806667,78.15946667,77.53183333,76.80516667,0.390312338,397085584,176803218.7,1
1/23/2014,78.5628,79.4999,77.8294,79.4542,100978346,AAPL,78.00877,0.657295461,-2.8087,1518.177645,-13.25899247,-1.145623796,18.55679662,95453400.88,367208.2001,24,72,-48,1.6705,78.92783333,80.02626667,80.59833333,81.69676667,78.35576667,77.25733333,76.68526667,0.972642921,498063930,177658214.7,1
1/24/2014,79.1428,79.3742,77.8214,78.0099,108384437,AAPL,78.14521,0.655654892,-1.8757,909.7373126,-46.60386942,-0.98395277,0.495207719,-82070080.52,-3379989.647,20,68,-48,1.6328,78.40183333,78.98226667,79.95463333,80.53506667,77.42946667,76.84903333,75.87666667,0.121393612,389679493,175688027.5,-1
1/27/2014,78.5813,79.2571,77.9642,78.6428,144219152,AAPL,78.39607,0.65497952,-2.11,727.2746644,-31.99196565,-0.887063891,18.08329368,7172473.875,-2900326.305,16,64,-48,1.2929,78.62136667,79.27853333,79.91426667,80.57143333,77.98563333,77.32846667,76.69273333,0.524866579,533898645,176858088,1
1/28/2014,72.6799,73.5714,71.7242,72.3571,266833581,AAPL,77.9785,0.648649624,5.6985,-142.4796493,-92.37864721,-0.841213633,-321.5229007,-83984974.01,-6586035.451,12,60,-48,6.9186,72.5509,73.3776,74.3981,75.2248,71.5304,70.7037,69.6832,0.342626678,267065064,155530823,-1
1/29/2014,71.9928,72.4814,71.2314,71.5356,125942796,AAPL,77.3265,0.640461508,8.0872,-103.8629845,-96.54204226,-0.803435363,-287.7184465,-64643918.33,-9225059.749,8,96,-88,1.25,71.74946667,72.26753333,72.99946667,73.51753333,71.01753333,70.49946667,69.76753333,0.24336,141122268,154100942.5,-1
1/30/2014,71.7914,72.3571,70.9571,71.3974,169762789,AAPL,76.50396,0.630984288,7.7811,-120.7522723,-95.14628393,-0.787437257,-227.9324222,-62981994.72,-11668582.97,4,96,-92,1.4,71.57053333,72.18396667,72.97053333,73.58396667,70.78396667,70.17053333,69.38396667,0.3145,-28640521,153772976.8,-1
1/31/2014,70.7399,71.6471,70.5071,71.5142,116336444,AAPL,75.73753,0.6220678,5.7243,-139.6969697,-89.42277396,-0.803587807,-195.9231743,89211683.64,-7083069.412,0,96,-96,1.14,71.2228,71.9385,72.3628,73.0785,70.7985,70.0828,69.6585,0.883421053,87695923,153963293.2,1
2/3/2014,71.8014,72.5328,71.3285,71.6471,100620772,AAPL,75.17839,0.614912762,6.7914,-126.6614815,-88.02697082,-1.08323404,-146.6114953,-47381914.64,-8914852.987,0,96,-96,1.2043,71.83613333,72.34376667,73.04043333,73.54806667,71.13946667,70.63183333,69.93516667,0.264552022,188316695,154150284.1,1
2/4/2014,72.2642,72.7799,71.8228,72.6842,94273543,AAPL,74.60296,0.607739771,6.1029,-106.1659902,-77.13466507,-1.351431115,-110.6145687,75420804.38,-5081378.293,0,92,-92,1.1328,72.42896667,73.03513333,73.38606667,73.99223333,72.07803333,71.47186667,71.12093333,0.900010448,282590238,155514904.4,1
2/5/2014,72.3656,73.6114,72.3216,73.2271,82322156,AAPL,74.04696,0.600815996,6.2271,-73.14758353,-71.43277249,-1.40351936,-78.9385027,33265861.15,-3338306.45,4,88,-84,1.2898,73.05336667,73.78513333,74.34316667,75.07493333,72.49533333,71.76356667,71.20553333,0.702046829,364912394,156129793.2,1
2/6/2014,72.8656,73.3571,72.5442,73.2156,64497223,AAPL,73.4231,0.593429278,4.7943,-78.45679116,-70.25489529,-1.697236665,-69.09344169,42043398.29,-1275484.174,0,84,-84,0.8129,73.03896667,73.53373333,73.85186667,74.34663333,72.72083333,72.22606667,71.90793333,0.825931849,300415171,156119664.2,-1
2/7/2014,74.4828,74.7042,73.9114,74.2399,93638601,AAPL,73.0461,0.588098423,4.4029,-190.1754152,-59.0058974,-1.995841818,-31.58483287,-16039508.09,-1946581.609,36,80,-44,1.4886,74.28516667,74.65893333,75.07796667,75.45173333,73.86613333,73.49236667,73.07333333,0.414354188,394053772,157429685.8,1
2/10/2014,74.0942,75.9985,73.9999,75.5699,86451022,AAPL,72.73881,0.583411317,-3.2128,-203.3256641,-44.39966175,-2.469735134,-8.036310039,49372158.77,386106.4547,32,76,-44,1.9986,75.18943333,76.37896667,77.18803333,78.37756667,74.38036667,73.19083333,72.38176667,0.785549885,480504794,158978446.8,1
2/11/2014,75.8014,76.8214,75.6428,76.5656,70672252,AAPL,73.15966,0.584489888,-5.03,-291.6812964,-33.46475285,-2.875178186,20.0615576,39995241.88,2186534.997,28,72,-44,1.2515,76.34326667,77.04373333,77.52186667,78.22233333,75.86513333,75.16466667,74.68653333,0.782962837,551177046,159909616,1
2/12/2014,76.7071,77.0799,76.1771,76.5599,77127064,AAPL,73.66209,0.586180708,-5.1625,-200.829216,-32.69282092,-3.386270235,27.25086289,-11721126.7,1554364.1,24,68,-44,0.9028,76.60563333,77.03416667,77.50843333,77.93696667,76.13136667,75.70283333,75.22856667,0.424014178,474049982,159903874.2,-1
2/13/2014,76.3799,77.8356,76.3142,77.7756,76960156,AAPL,74.29991,0.588929802,-6.2614,-2999.701238,-18.02844222,-3.05329542,45.68372834,70889945.19,4706002.629,20,64,-44,1.5214,77.30846667,78.30273333,78.82986667,79.82413333,76.78133333,75.78706667,75.25993333,0.96056264,551010138,161125929.9,1
2/14/2014,77.4956,77.9971,77.3156,77.7128,68468036,AAPL,74.91977,0.591496489,-6.0657,-687.6774194,-17.64914286,-2.542839209,53.39762015,11342687.11,5007672.043,16,60,-44,0.6815,77.67516667,78.03473333,78.35666667,78.71623333,77.35323333,76.99366667,76.67173333,0.582831988,482542102,161070645.3,-1
2/18/2014,77.9999,78.7413,77.9442,77.9985,65306248,AAPL,75.55491,0.594150157,-5.3143,118.4298224,-9.020912778,-2.022191701,62.11083168,-56408671.12,2216002.966,12,56,-44,1.0285,78.228,78.5118,79.0251,79.3089,77.7147,77.4309,76.9176,0.068121942,547848350,161310734.4,1
2/19/2014,77.8214,78.1271,76.3356,76.7671,78554420,AAPL,75.9632,0.594987699,-3.54,127.7090701,-23.9756139,-1.532166399,41.00217128,-40713245.31,264662.0792,8,52,-44,1.7915,77.0766,77.8176,78.8681,79.6091,76.0261,75.2851,74.2346,0.240859615,469293930,160070557.8,-1
2/20/2014,76.1414,76.7142,75.5714,75.8785,76529103,AAPL,76.22834,0.594686807,-2.6629,149.0950883,-34.7671905,-1.011409562,23.46668764,-35398393.28,-1356394.948,4,48,-44,1.1957,76.0547,76.538,77.1975,77.6808,75.3952,74.9119,74.2524,0.268725936,392764827,159184712.7,-1
2/21/2014,76.1132,76.3671,74.9428,75.0356,69757247,AAPL,76.41034,0.593722928,-0.7957,186.4116545,-45.00376479,-0.516841782,14.51821286,-60667206.25,-4052355.291,0,44,-44,1.4243,75.4485,75.9542,76.8728,77.3785,74.5299,74.0242,73.1056,0.065154813,323007580,158409810.9,-1
2/24/2014,74.7356,75.7028,74.6314,75.3642,72364950,AAPL,76.52277,0.592244484,0.2057,181.8622044,-45.55768401,0.046620486,15.18691204,26625222.41,-2657912.844,12,40,-28,1.0714,75.2328,75.8342,76.3042,76.9056,74.7628,74.1614,73.6914,0.683964906,395372530,158726715.4,1
2/25/2014,75.6256,75.6521,74.4285,74.5799,58247350,AAPL,76.42377,0.589155654,1.9857,301.8884845,-60.1488762,0.603974762,11.59226744,-43833082.61,-4529520.563,8,36,-28,1.2236,74.88683333,75.34516667,76.11043333,76.56876667,74.12156667,73.66323333,72.89796667,0.123733246,337125180,158120547,-1
2/26/2014,74.8014,74.9999,73.6571,73.9071,69131286,AAPL,76.15792,0.584819592,2.6528,761.7647059,-75.30258423,0.914709961,-21.97342246,-43389818.17,-6295905.919,4,32,-28,1.3428,74.18803333,74.71896667,75.53083333,76.06176667,73.37616667,72.84523333,72.03336667,0.186178135,267993894,157496900.1,-1
2/27/2014,73.8771,75.5399,73.7214,75.3814,75557321,AAPL,76.04007,0.581676504,2.3942,307.2444362,-54.21729519,1.170511372,2.741421277,62386207.03,-3173977.873,0,28,-28,1.8185,74.8809,76.0404,76.6994,77.8589,74.2219,73.0624,72.4034,0.912840253,343551215,159004118.7,1
2/28/2014,75.5828,76.1071,74.5885,75.1771,93074653,AAPL,75.78022,0.577495362,2.5357,600.7255655,-70.10345777,1.314317144,16.71734724,-20924329.34,-3980815.44,0,24,-24,1.5186,75.2909,75.9933,76.8095,77.5119,74.4747,73.7723,72.9561,0.387593836,250476562,158751866.1,-1
3/3/2014,74.7742,75.8071,74.6871,75.3942,59667923,AAPL,75.54836,0.573567722,2.6043,-2570.916335,-65.83336611,1.508098471,5.085163303,15673484.77,-3087434.554,0,20,-20,1.12,75.29613333,75.90516667,76.41613333,77.02516667,74.78516667,74.17613333,73.66516667,0.631339286,310144485,158924178,1
3/4/2014,75.8571,76.0914,75.3956,75.8914,64884834,AAPL,75.33765,0.569847182,0.8757,-596.0545832,-56.0540498,1.453009719,24.82512744,27583980.88,-1693273.939,0,16,-16,0.6972,75.7928,76.19,76.4886,76.8858,75.4942,75.097,74.7984,0.712561081,375029319,159352072.2,1
3/5/2014,75.8456,76.3928,75.5899,76.0514,50065519,AAPL,75.26608,0.567191632,-0.1729,-821.7502458,-52.90704536,1.435947869,28.32323322,7488938.637,-1275899.106,56,12,44,0.8029,76.01136667,76.43283333,76.81426667,77.23573333,75.62993333,75.20846667,74.82703333,0.574791381,425094838,159457624.1,1
3/6/2014,76.1128,76.3485,75.4428,75.8214,46423111,AAPL,75.26037,0.565035503,-0.7858,-151.61703,-57.43086425,0.961427004,9.7307206,-7611606.474,-1563886.815,52,8,44,0.9057,75.8709,76.299,76.7766,77.2047,75.3933,74.9652,74.4876,0.418019212,378671727,159317228,-1
3/7/2014,75.8699,75.9971,75.1499,75.7771,55415241,AAPL,75.33452,0.56347927,-0.4129,-153.0660743,-58.3021911,0.573818632,-18.67971017,26634898.65,-282119.5474,48,4,44,0.8472,75.64136667,76.13283333,76.48856667,76.98003333,75.28563333,74.79416667,74.43843333,0.740321058,323256486,159284850.7,-1
3/10/2014,75.4799,76.1899,75.4769,75.8456,44691430,AAPL,75.38266,0.561744638,-1.2657,-127.5349529,-56.95487982,0.28142831,-10.92122831,1529412.191,-199776.9324,44,0,44,0.713,75.83746667,76.19803333,76.55046667,76.91103333,75.48503333,75.12446667,74.77203333,0.517110799,367947916,159325250.3,1
3/11/2014,76.4928,76.9628,76.0842,76.5842,70198849,AAPL,75.58309,0.561149328,-2.6771,-1905.030071,-34.51677852,0.121207617,80.33329171,9699681.617,250199.8292,40,0,40,1.1172,76.54373333,77.00326667,77.42233333,77.88186667,76.12466667,75.66513333,75.24606667,0.569087184,438146765,160008861.1,1
3/12/2014,76.3585,76.7642,75.9999,76.6585,50195460,AAPL,75.85823,0.561096243,-1.2771,456.2307692,-9.205312037,-0.077276628,87.04943026,36311749.1,1889365.934,36,0,36,0.7643,76.4742,76.9485,77.2385,77.7128,76.1842,75.7099,75.4199,0.86170352,488342225,160057559.4,1
3/13/2014,76.7771,77.0942,75.5942,75.8071,64435609,AAPL,75.9008,0.559334001,-0.63,461.257291,-37.44726659,-0.124817196,35.96869626,-46144487.46,-293997.1089,32,0,32,1.5,76.16516667,76.73613333,77.66516667,78.23613333,75.23613333,74.66516667,73.73613333,0.141933333,423906616,159341911.7,-1
3/14/2014,75.5414,75.8414,74.7142,74.9556,59299492,AAPL,75.87865,0.557095045,0.4386,-790.5041605,-62.22105845,-0.058246023,-164.7798948,-33900454.79,-1821567.421,28,0,28,1.1272,75.1704,75.6266,76.2976,76.7538,74.4994,74.0432,73.3722,0.214158978,364607124,158675832.7,-1
3/17/2014,75.3856,75.7099,75.1214,75.2485,49886074,AAPL,75.86408,0.554935427,0.6429,526.9069698,-53.69933956,-0.182326552,-88.99080684,-28338002.61,-3026862.983,24,48,-24,0.7543,75.35993333,75.59846667,75.94843333,76.18696667,75.00996667,74.77143333,74.42146667,0.215972812,414493198,158870769.9,1
3/18/2014,75.1285,75.9956,75.0285,75.9142,52411863,AAPL,75.86636,0.552930135,0.1372,208.6891535,-34.33126764,-0.198937098,0.558503351,43588937.45,-907957.8397,20,44,-24,0.9671,75.6461,76.2637,76.6132,77.2308,75.2966,74.679,74.3295,0.915830834,466905061,159334441.3,1
3/19/2014,76.0371,76.6056,75.5714,75.8942,56188958,AAPL,75.85064,0.550810722,-0.0728,529.3096724,-35.57874763,-0.159028739,101.9876013,-21112965.65,-1826369.406,16,40,-24,1.0342,76.02373333,76.47606667,77.05793333,77.51026667,75.44186667,74.98953333,74.40766667,0.312125314,410716103,159319638,-1
3/20/2014,75.6985,76.0956,75.3356,75.5285,52099537,AAPL,75.82135,0.548601213,0.2486,772.4245874,-62.48553298,-0.1317455,17.73667107,-25652166.77,-2909362.581,12,36,-24,0.76,75.65323333,75.97086667,76.41323333,76.73086667,75.21086667,74.89323333,74.45086667,0.253815789,358616566,159068593.8,-1
3/21/2014,75.9899,76.2499,75.1899,76.1242,93612169,AAPL,75.85606,0.546876202,-0.2786,423.6849315,-40.29745337,-0.112145473,59.33296895,71410188.54,468805.9381,8,32,-24,1.06,75.85466667,76.51943333,76.91466667,77.57943333,75.45943333,74.79466667,74.39943333,0.881415094,452228735,159806921.3,1
3/24/2014,76.9171,77.2142,76.4371,77.0271,88924871,AAPL,75.97421,0.545773567,-0.4429,308.0567051,-7.484,0.040606168,262.5865065,46104530.34,2543161.211,4,28,-24,1.09,76.8928,77.3485,77.6699,78.1256,76.5714,76.1157,75.7943,0.759233046,541153606,160861648.5,1
3/25/2014,77.3571,77.9642,77.0842,77.8556,70573356,AAPL,76.10135,0.54476007,-1.1971,230.9666334,-3.341538462,0.2267999,328.9461617,53154568.59,4843684.137,0,24,-24,0.9371,77.63466667,78.18513333,78.51466667,79.06513333,77.30513333,76.75466667,76.42513333,0.876590909,611726962,161620732.3,1
3/26/2014,78.0742,78.4285,76.9799,77.1114,74942224,AAPL,76.14664,0.54315906,-1.3043,323.0310078,-35.46024823,0.415851978,216.9345318,-61336118.17,1835505.803,0,20,-20,1.4486,77.5066,78.0333,78.9552,79.4819,76.5847,76.058,75.1361,0.090777302,536784738,160904380.5,-1
3/27/2014,77.1449,77.3571,76.4457,76.7799,55507676,AAPL,76.24392,0.541922002,-1.8243,415.5464699,-44.3852139,0.424861343,91.84080898,-14799610.78,1079362.819,96,16,80,0.9114,76.8609,77.2761,77.7723,78.1875,76.3647,75.9495,75.4533,0.366688611,481277062,160665754.3,-1
3/28/2014,76.9028,76.9913,76.3214,76.6942,50141063,AAPL,76.41778,0.541220824,-1.4457,482.9837379,-46.69251272,0.36346213,57.27946114,5666037.422,1287848.376,92,12,80,0.6699,76.66896667,77.01653333,77.33886667,77.68643333,76.34663333,75.99906667,75.67673333,0.55650097,431135999,160609788,-1
3/31/2014,77.0328,77.2585,76.5614,76.6771,42167188,AAPL,76.56064,0.540305417,-0.7629,3616.79225,-47.15289557,0.365121051,63.62807791,-28169931.79,-51143.76168,88,8,80,0.6971,76.83233333,77.10326667,77.52943333,77.80036667,76.40616667,76.13523333,75.70906667,0.165973318,388968811,160600386.3,-1
4/1/2014,76.8228,77.4099,76.6814,77.3785,50189685,AAPL,76.70707,0.539435019,-1.4843,553.7638889,-28.26912204,0.53125113,89.55489435,45863106.8,2035870.797,84,4,80,0.7328,77.1566,77.6318,77.8851,78.3603,76.9033,76.4281,76.1748,0.956897735,439158496,161059493.9,1
4/2/2014,77.4828,77.6399,77.1799,77.5071,44792195,AAPL,76.86836,0.538672402,-1.9786,242.1,-24.80682767,0.628323966,106.847744,18929571.1,2803767.378,80,0,80,0.46,77.4423,77.7047,77.9023,78.1647,77.2447,76.9823,76.7847,0.711304348,483950691,161133936.8,1
4/3/2014,77.3414,77.4999,76.8056,76.9699,40648111,AAPL,77.0125,0.537780597,-0.8457,204.3240828,-39.26984896,0.589165024,60.33081813,-21410073.73,1703136.714,76,0,76,0.7015,77.0918,77.378,77.7861,78.0723,76.6837,76.3975,75.9894,0.236641221,443302580,160852205.6,-1
4/4/2014,77.1156,77.1428,75.7971,75.9742,68812485,AAPL,76.9975,0.535781303,1.0529,526.7741491,-72.18529412,0.624674135,-13.71151361,-50700437.6,-678847.0825,72,0,72,1.3457,76.3047,76.8123,77.6504,78.158,75.4666,74.959,74.1209,0.131604369,374490095,159962031.8,-1
4/7/2014,75.4314,75.8428,74.5556,74.7814,72462530,AAPL,76.77293,0.532342177,3.0742,-278.6987994,-94.1697436,0.67452085,-126.1851397,-47039846.23,-2786167.882,68,0,68,1.4186,75.05993333,75.56426667,76.34713333,76.85146667,74.27706667,73.77273333,72.98986667,0.175419515,302027565,158824365.2,-1
4/8/2014,75.0271,75.1599,74.0999,74.7771,60971883,AAPL,76.46508,0.528367731,2.3343,-282.6157014,-84.35521878,0.658935751,-134.7536779,16934077.69,-1889792.005,64,96,-32,1.06,74.67896667,75.25803333,75.73896667,76.31803333,74.19803333,73.61896667,73.13803333,0.638867925,241055682,158820859.3,-1
4/9/2014,74.6628,75.7842,74.5742,75.7599,51542722,AAPL,76.32993,0.525618158,1.02,1789.066551,-61.65041815,0.570158013,-66.34774096,49472493.66,444860.0256,60,96,-36,1.21,75.37276667,76.17133333,76.58276667,77.38133333,74.96133333,74.16276667,73.75133333,0.979917355,292598404,159498288.5,1
4/10/2014,75.8114,76.0342,74.7385,74.7828,59912818,AAPL,76.13022,0.522432876,1.9114,-264.2164902,-84.22353648,0.339501972,-71.96545886,-55815977.93,-2112453.595,56,92,-36,1.2957,75.18516667,75.63183333,76.48086667,76.92753333,74.33613333,73.88946667,73.04043333,0.034190013,232685586,158725573.4,-1
4/11/2014,74.1428,74.6899,73.8771,74.2299,67975012,AAPL,75.88379,0.518947658,2.4472,-94.42656943,-92.24853891,0.163469032,-125.5619942,-8965208.276,-2423942.77,52,88,-36,0.9057,74.26563333,74.65416667,75.07843333,75.46696667,73.84136667,73.45283333,73.02856667,0.434055118,164710574,158223006.2,-1
4/14/2014,74.5571,74.5942,73.8871,74.5256,51445177,AAPL,75.66864,0.515708129,2.8529,-63.31831832,-85.75163686,0.021820361,-112.1348112,41463168.4,-429072.0876,48,96,-48,0.7071,74.33563333,74.78416667,75.04273333,75.49126667,74.07706667,73.62853333,73.36996667,0.902984019,216155751,158427941.7,1
4/15/2014,74.3242,74.5199,73.0471,73.9942,66622577,AAPL,75.33021,0.511661562,3.5129,-67.64083152,-82.40049058,-0.131178178,-137.0674071,19062163.19,456893.9973,44,92,-48,1.4785,73.85373333,74.66036667,75.32653333,76.13316667,73.18756667,72.38093333,71.71476667,0.643060837,149533174,157952893.6,-1
4/16/2014,74.0071,74.4414,73.4478,74.1442,53732994,AAPL,74.99392,0.507667816,2.8257,-85.68881132,-76.11261104,-0.247450794,-115.7686833,21588376.82,1417416.818,40,96,-56,0.9936,74.01113333,74.57446667,75.00473333,75.56806667,73.58086667,73.01753333,72.58726667,0.700885668,203266168,158061820.4,1
4/17/2014,74.2856,75.3942,74.1714,74.9914,71106721,AAPL,74.79607,0.504644653,0.9828,-182.3878318,-57.66634733,-0.452813354,-58.40106821,24260487.41,2455739.111,36,92,-56,1.25,74.85233333,75.53326667,76.07513333,76.75606667,74.31046667,73.62953333,73.08766667,0.670592084,274372889,158874313,1
4/21/2014,75.0485,76.0199,74.8514,75.8814,45668931,AAPL,74.78679,0.502910864,-1.1,-502.1616187,-38.28819021,-0.730377421,-16.07248226,34842834.39,3927881.026,32,88,-56,1.1685,75.58423333,76.31706667,76.75273333,77.48556667,75.14856667,74.41573333,73.98006667,0.881471973,320041820,159416313.2,1
4/22/2014,75.4728,75.9751,75.2144,75.9569,50664453,AAPL,74.90434,0.502024743,-1.1798,-237.0427687,-36.64431284,-1.00878428,-5.833855979,48240125.29,5942075.542,28,84,-56,0.7607,75.71546667,76.21653333,76.47616667,76.97723333,75.45583333,74.95476667,74.69513333,0.976074668,370706273,159466723,1
4/23/2014,75.5799,75.8756,74.9214,74.9642,98735259,AAPL,74.92305,0.50047157,0.7957,-127.4607731,-58.25857864,-1.17473214,-26.00857062,-89877851.57,1586621.018,24,80,-56,1.0355,75.25373333,75.58606667,76.20793333,76.54026667,74.63186667,74.29953333,73.67766667,0.044854328,271971014,158176326.8,-1
4/24/2014,81.1728,81.4285,80.1042,81.1099,189978082,AAPL,75.45805,0.502438976,-6.3271,226.736715,-3.80127425,-0.98343749,302.859609,98568255.03,5994880.29,20,76,-56,6.4643,80.88086667,81.65753333,82.20516667,82.98183333,80.33323333,79.55656667,79.00893333,0.759420071,461949096,173751071.8,1
4/25/2014,80.6471,81.7128,80.5656,81.7056,97568814,AAPL,76.15033,0.50541869,-7.4757,174.1738493,-0.08308619,-0.752628908,246.9508242,96344100.85,10101665.87,96,72,24,1.1472,81.328,82.0904,82.4752,83.2376,80.9432,80.1808,79.796,0.993723849,559517910,174467651.9,1
4/28/2014,81.8285,85.1071,81.7928,84.8699,167371680,AAPL,77.21433,0.51084604,-10.3443,130.315706,-1.966832504,-0.574424762,280.2688142,143414547.3,16161346.28,96,68,28,3.4015,83.92326667,86.05373333,87.23756667,89.36803333,82.73943333,80.60896667,79.42513333,0.928431343,726889590,180949633.7,1
4/29/2014,84.8199,85.1399,84.2156,84.6185,84344673,AAPL,78.22362,0.515854466,-10.6243,133.5877009,-4.311656523,-0.1950948,235.3365712,-10813419.62,14935219.79,96,64,32,0.9243,84.658,85.1004,85.5823,86.0247,84.1761,83.7337,83.2518,0.435897436,642544917,180699789.5,-1
4/30/2014,84.6628,85.6328,84.2571,84.2985,114220883,AAPL,79.25405,0.520937317,-10.1543,142.4601223,-10.60171464,0.359512665,188.551306,-107346208.9,9376969.7,96,60,36,1.3757,84.72946667,85.20183333,86.10516667,86.57753333,83.82613333,83.35376667,82.45043333,0.03009377,528324034,180267842.8,-1
5/1/2014,84.5713,84.9713,83.7656,84.4971,61052418,AAPL,80.28934,0.526000185,-9.5057,127.2629011,-9.023733285,0.990137212,145.8538122,13028769.31,9542960.686,96,56,40,1.2057,84.41133333,85.05706667,85.61703333,86.26276667,83.85136667,83.20563333,82.64566667,0.606701501,589376452,180411677,1
5/2/2014,84.6199,84.8856,84.2442,84.6542,47878572,AAPL,81.25562,0.530568989,-8.7728,120.1020692,-7.775491232,1.719933075,125.1624437,13331950.36,9715187.583,92,52,40,0.6414,84.59466667,84.94513333,85.23606667,85.58653333,84.30373333,83.95326667,83.66233333,0.639226692,637255024,180500694.5,1
5/5/2014,84.3056,85.8571,84.2856,85.8513,71766758,AAPL,82.25261,0.535309308,-9.8944,118.5021676,-0.045277127,2.516585227,119.1492727,71237012.92,12511635.65,88,48,40,1.5715,85.33133333,86.37706667,86.90283333,87.94856667,84.80556667,83.75983333,83.23406667,0.996309259,709021782,181515552.5,1
5/6/2014,85.9713,86.3442,84.9156,84.9156,93641373,AAPL,83.14848,0.53933425,-9.9514,122.8890069,-10.74369599,3.249923059,101.6755492,-93641373,7686496.491,96,44,52,1.4286,85.3918,85.868,86.8204,87.2966,84.4394,83.9632,83.0108,0,615380409,180494947.9,-1
5/7/2014,85.0356,85.3271,83.9613,84.6185,70715988,AAPL,84.11391,0.543750089,-3.5086,126.7025004,-13.38125368,3.928254602,76.45665156,-2661298.714,7216141.94,96,40,56,1.3658,84.63563333,85.30996667,86.00143333,86.67576667,83.94416667,83.26983333,82.57836667,0.481183189,544664421,180247529,-1
5/8/2014,84.0356,84.9156,83.7713,83.9985,57574363,AAPL,84.40277,0.543823392,-2.2929,137.9356286,-19.27001183,4.70024987,60.85762693,-34711660.43,5310331.878,92,36,56,1.1443,84.22846667,84.68563333,85.37276667,85.82993333,83.54133333,83.08416667,82.39703333,0.198549331,487090058,179825681.5,-1
5/9/2014,83.5056,83.7499,82.9042,83.6488,72899498,AAPL,84.59709,0.543286849,1.2211,148.492417,-23.45294445,5.696047783,41.9689723,55469820.22,7590309.607,88,32,56,1.0943,83.4343,83.9644,84.28,84.8101,83.1187,82.5886,82.273,0.880454062,414190560,179522188.5,-1
5/12/2014,83.9271,84.8085,83.9142,84.6899,53324677,AAPL,84.57909,0.541436194,-0.0714,143.1306538,-14.48243863,5.907353026,47.03408005,39181086.05,9026254.583,84,28,56,1.1597,84.47086667,85.02753333,85.36516667,85.92183333,84.13323333,83.57656667,83.23893333,0.86738231,467515237,180185871.9,1
5/13/2014,84.5713,84.9342,84.3856,84.8228,39934594,AAPL,84.59952,0.539841323,-0.5243,128.1368551,-13.31897608,6.005920502,41.4897259,23716169.75,9693978.263,80,24,56,0.5486,84.7142,85.0428,85.2628,85.5914,84.4942,84.1656,83.9456,0.796937659,507449831,180248539.5,1
5/14/2014,84.6328,85.3428,84.5342,84.8385,41600846,AAPL,84.65352,0.538466279,-0.3414,174.3952154,-24.12980769,5.601515979,35.71589178,-10289598.32,8785633.531,76,20,56,0.8086,84.90516667,85.27613333,85.71376667,86.08473333,84.46753333,84.09656667,83.65893333,0.376329458,549050677,180256239.4,1
5/15/2014,84.9571,85.2285,84.0056,84.1171,57711731,AAPL,84.61552,0.536511187,0.5371,244.9429815,-38.54047693,5.196516387,24.89864016,-47187799.35,6241385.669,72,16,56,1.2229,84.4504,84.8952,85.6733,86.1181,83.6723,83.2275,82.4494,0.091176711,491338946,179765504.2,-1
5/16/2014,84.0899,85.3613,83.6285,85.3585,69091834,AAPL,84.68595,0.535267536,0.4928,815.3704462,-21.65707255,4.913686282,23.89975382,68868545.52,9088075.729,68,12,56,1.7328,84.78276667,85.93703333,86.51556667,87.66983333,84.20423333,83.04996667,82.47143333,0.998384118,560430780,180785161.3,1
5/19/2014,85.4071,86.7613,85.3328,86.3699,79439024,AAPL,84.73781,0.533935441,-1.4543,285.2175403,-10.14752016,4.559661289,37.21357579,35907439.83,10307138.13,64,8,56,1.4285,86.15466667,86.97653333,87.58316667,88.40503333,85.54803333,84.72616667,84.11953333,0.7260063,639869804,181726422.3,1
5/20/2014,86.3585,86.6285,85.8185,86.3871,58708986,AAPL,84.88496,0.533199002,-1.7686,239.9932969,-9.701589277,4.140095328,34.25213972,23715531.13,10916610.73,96,4,92,0.81,86.27803333,86.73756667,87.08803333,87.54756667,85.92756667,85.46803333,85.11756667,0.701975309,698578790,181738113.9,1
5/21/2014,86.2613,86.6713,86.0085,86.6156,49249914,AAPL,85.08467,0.532792085,-2.6171,238.0174652,-3.777449379,3.561675718,30.8281464,40972242.88,12282776.24,92,0,92,0.6628,86.4318,86.8551,87.0946,87.5179,86.1923,85.769,85.5295,0.915962583,747828704,181868383.4,1
5/22/2014,86.6571,87.1213,86.2999,86.7528,50218945,AAPL,85.3601,0.532850903,-3.104,239.3262175,-8.738232435,3.060774373,33.63257497,5160066.908,11959016.63,88,0,88,0.8214,86.72466667,87.14943333,87.54606667,87.97083333,86.32803333,85.90326667,85.50663333,0.5513757,798047649,181947930.7,1
5/23/2014,86.7499,87.8184,86.6385,87.7328,58052491,AAPL,85.7685,0.533736204,-3.0429,255.4026043,-1.741890847,2.621182626,43.81474256,49629246.27,13671300.26,96,0,96,1.1799,87.39656667,88.15463333,88.57646667,89.33453333,86.97473333,86.21666667,85.79483333,0.927451479,856100140,182603718.6,1
5/27/2014,87.9828,89.4085,87.9471,89.3756,87216605,AAPL,86.23707,0.535006668,-4.5528,144.5784753,-0.505819227,2.35810108,74.75472054,83289649.61,16835771.5,96,0,96,1.6757,88.9104,89.8737,90.3718,91.3351,88.4123,87.449,86.9509,0.977487341,943316745,184236852.9,1
5/28/2014,89.4313,89.9756,89.1113,89.1442,78921885,AAPL,86.66921,0.536034298,-4.3057,142.4796164,-11.75721922,2.204342253,85.7942516,-72913485.1,12756258.83,96,4,92,0.8643,89.41036667,89.70943333,90.27466667,90.57373333,88.84513333,88.54606667,87.98083333,0.038065487,864394860,184032518.3,-1
5/29/2014,89.6928,90.9813,89.6813,90.7685,94118633,AAPL,87.26221,0.538053057,-6.6514,119.239291,-2.634608956,1.965569456,106.7224706,63305640.53,15053958.54,96,0,96,1.8371,90.47703333,91.27276667,91.77703333,92.57276667,89.97276667,89.17703333,88.67276667,0.836307692,958513493,185747457.7,1
5/30/2014,91.1399,92.0242,89.8428,90.4285,141005137,AAPL,87.89335,0.540272071,-5.07,119.0686904,-17.49671053,1.648704647,105.3867935,-65286141.18,11402135,96,0,96,2.1814,90.76516667,91.68753333,92.94656667,93.86893333,89.50613333,88.58376667,87.32473333,0.268497295,817508356,185219281.6,-1
6/2/2014,90.5656,90.6899,88.9285,89.8071,92337903,AAPL,88.33821,0.541331896,-3.4372,137.4071758,-26.40756578,1.710855568,74.81410698,-220176.6734,10873848,96,0,96,1.7614,89.8085,90.6885,91.5699,92.4499,88.9271,88.0471,87.1657,0.498807767,725170453,184584760.7,-1
6/3/2014,89.7799,91.2485,89.7499,91.0771,73231620,AAPL,88.80893,0.542556048,-4.69,130.606143,-11.28077468,1.972027203,89.13003544,56480119.04,12946860.74,92,0,92,1.4986,90.69183333,91.63376667,92.19043333,93.13236667,90.13516667,89.19323333,88.63656667,0.885626585,798402073,185620359.9,1
6/4/2014,91.0628,92.5556,90.8728,92.1171,83870521,AAPL,89.38193,0.544395708,-5.5015,126.2990135,-4.912009499,2.32635235,106.3000538,40160961.39,14183865.56,88,32,56,1.6828,91.8485,92.8242,93.5313,94.507,91.1414,90.1657,89.4586,0.739422391,882272594,186578068.7,1
6/5/2014,92.3142,92.767,91.8013,92.4785,75951141,AAPL,89.96822,0.546299607,-5.7257,114.2655536,-3.156973245,2.573730855,104.462888,30570786.48,14928725.74,96,28,68,0.9657,92.34893333,92.89656667,93.31463333,93.86226667,91.93086667,91.38323333,90.96516667,0.701252977,958223735,186876045.3,1
6/6/2014,92.8428,93.037,92.0671,92.2242,87620911,AAPL,90.51536,0.547943545,-4.4914,121.077239,-8.638996652,2.827971137,91.80310931,-59236036.03,11557599.6,96,24,72,0.9699,92.44276667,92.81843333,93.41266667,93.78833333,91.84853333,91.47286667,90.87863333,0.161975461,870602824,186635102.9,-1
6/9/2014,92.7,93.88,91.75,93.7,75414804,AAPL,91.11208,0.549888817,-4.3244,119.7418862,-2.105952827,3.138167218,90.2439797,62668639.94,13880829.11,96,20,76,2.13,93.11,94.47,95.24,96.6,92.34,90.98,90.21,0.915492958,946017628,187841913.7,1
6/10/2014,94.73,95.05,93.57,94.25,62777042,AAPL,91.59952,0.551174986,-5.1058,118.4041511,-8.66598061,3.497870753,99.10122695,-5090030.432,13018517.17,96,16,80,1.48,94.29,95.01,95.77,96.49,93.53,92.81,92.05,0.459459459,1008794670,188210402.2,1
6/11/2014,94.13,94.76,93.47,93.86,45681114,AAPL,92.0711,0.552344004,-3.0915,125.3588979,-13.16153293,3.833142298,81.08109662,-18059975.3,11605858.2,96,12,84,1.29,94.03,94.59,95.32,95.88,93.3,92.74,92.01,0.302325581,963113556,188021376.9,-1
6/12/2014,94.04,94.12,91.9,92.29,54748791,AAPL,92.22325,0.551590643,-1.8615,161.5310988,-31.54249666,3.877653743,50.37162289,-35512729.3,9464103.906,92,8,84,2.22,92.77,93.64,94.99,95.86,91.42,90.55,89.2,0.175675676,908364765,187105591.7,-1
6/13/2014,92.2,92.44,90.88,91.28,54525280,AAPL,92.3084,0.550428206,-1.4729,224.5235679,-44.81959222,3.928906482,24.14893122,-26563597.95,7826480.862,88,4,84,1.56,91.53333333,92.18666667,93.09333333,93.74666667,90.62666667,89.97333333,89.06666667,0.256410256,853839485,186508879.9,-1
6/16/2014,91.51,92.75,91.45,92.2,35561270,AAPL,92.54769,0.550188942,-1.1229,256.3907379,-40.12445621,3.751445058,28.21406678,5470964.615,7719411.928,84,0,84,1.47,92.13333333,92.81666667,93.43333333,94.11666667,91.51666667,90.83333333,90.21666667,0.576923077,889400755,186867297.6,1
6/17/2014,92.31,92.7,91.8,92.08,29726347,AAPL,92.64798,0.549134504,0.0371,246.6618979,-48.51752022,3.599040695,25.114265,-11229953.31,6858077.033,80,16,64,0.9,92.19333333,92.58666667,93.09333333,93.48666667,91.68666667,91.29333333,90.78666667,0.311111111,859674408,186828608.2,-1
6/18/2014,92.27,92.29,91.35,92.18,33514108,AAPL,92.65427,0.547539942,0.2985,405.0442791,-46.88393368,3.60968135,16.91340657,25670380.6,7713181.846,76,12,64,0.94,91.94,92.53,92.88,93.47,91.59,91,90.65,0.882978723,893188516,186865005,1
6/19/2014,92.29,92.3,91.3389,91.86,35527686,AAPL,92.59242,0.545554176,0.3642,399.3852602,-52.1114106,3.457029453,11.13908615,2997914.197,7498851.473,72,8,64,0.9611,91.83296667,92.32703333,92.79406667,93.28813333,91.36593333,90.87186667,90.40483333,0.542191239,857660830,186741671.7,-1
6/20/2014,91.85,92.55,90.9,90.91,100898066,AAPL,92.461,0.543162656,2.79,518.3788195,-67.63048272,3.134708854,-0.322304241,-99675059.14,2627309.535,68,4,64,1.65,91.45333333,92.00666667,93.10333333,93.65666667,90.35666667,89.80333333,88.70666667,0.006060606,756762764,185698201.6,-1
6/23/2014,91.32,91.62,90.6,90.83,43694391,AAPL,92.174,0.539889502,3.42,-1799.757183,-79.62113922,2.699271147,-13.77551231,-23989077.41,1417473.635,64,0,64,1.02,91.01666667,91.43333333,92.03666667,92.45333333,90.41333333,89.99666667,89.39333333,0.225490196,713068373,185659750.9,-1
6/24/2014,90.75,91.74,90.19,90.28,39036087,AAPL,91.777,0.535998854,3.58,-185.4662239,-98.14814815,2.343011142,-23.69984089,-34502863.99,-215269.1516,60,0,60,1.55,90.73666667,91.28333333,92.28666667,92.83333333,89.73333333,89.18666667,88.18333333,0.058064516,674032286,185423377,-1
6/25/2014,90.21,90.7,89.65,90.36,36868541,AAPL,91.427,0.532408267,1.93,-147.5477932,-86.85185185,1.82317105,-40.3583972,12991771.59,385050.9407,56,0,56,1.05,90.23666667,90.82333333,91.28666667,91.87333333,89.77333333,89.18666667,88.72333333,0.676190476,710900827,185456047.3,1
6/26/2014,90.37,91.05,89.8,90.9,32629359,AAPL,91.288,0.530059132,0.38,-276.8312944,-76.85185185,1.203259766,-34.74372442,24798312.84,1494744.767,52,0,52,1.25,90.58333333,91.36666667,91.83333333,92.61666667,90.11666667,89.33333333,88.86666667,0.88,743530186,185651043.5,1
6/27/2014,90.82,92,90.77,91.98,64028803,AAPL,91.358,0.52893484,0.22,-190.1162791,-56.85185185,0.636882248,-7.924968557,61946565.5,4242555.045,48,0,48,1.23,91.58333333,92.39666667,92.81333333,93.62666667,91.16666667,90.35333333,89.93666667,0.983739837,807558989,186411781.8,1
6/30/2014,92.1,93.725,92.09,92.93,49589028,AAPL,91.431,0.527848761,-0.85,-278.030303,-39.25925926,0.290226637,35.60011833,1364835.633,4111749.606,44,0,44,1.745,92.915,93.74,94.55,95.375,92.105,91.28,90.47,0.513761468,857148017,186923953.7,1
7/2/2014,93.865,94.06,93.09,93.48,28465073,AAPL,91.705,0.526432115,-1.62,357.9831933,-14.31767338,-0.01972706,75.18644534,-5575632.856,3210721.118,36,12,24,0.97,93.54333333,93.99666667,94.51333333,94.96666667,93.02666667,92.57333333,92.05666667,0.402061856,866906421,187154454.4,-1
7/8/2014,96.27,96.8,93.92,95.35,65221678,AAPL,92.8798,0.528668754,-5.07,178.2262997,-20.27972028,-0.210701872,165.5835668,-452928.3194,5965533.952,96,0,96,2.88,95.35666667,96.79333333,98.23666667,99.67333333,93.91333333,92.47666667,91.03333333,0.496527778,881044435,188032965.3,-1
1/2/2015,111.39,111.44,107.35,109.33,53204626,AAPL,112.205,0.471981277,3.32,-394.9781659,-34.49587825,-2.35176074,-69.00204931,-1691100.582,-4406504,0,56,-56,4.09,109.3733333,111.3966667,113.4633333,115.4866667,107.3066667,105.2833333,103.2166667,0.484107579,1029645146,192360639.4,-1
1/5/2015,108.29,108.65,105.41,106.25,64285491,AAPL,111.565,0.468282532,5.53,-259.9137931,-54.02663285,-1.530038236,-125.9982066,-30952273.44,-5613129.884,4,52,-48,3.92,106.77,108.13,110.01,111.37,104.89,103.53,101.65,0.259259259,965359655,190549614.9,-1
1/6/2015,106.54,107.43,104.63,106.26,65797116,AAPL,111.013,0.46496946,6.68,-460.8142494,-53.96322131,-0.946018956,-131.1916732,10809526.2,-4866645.516,0,96,-96,2.8,106.1066667,107.5833333,108.9066667,110.3833333,104.7833333,103.3066667,101.9833333,0.582142857,1031156771,190555807.5,1
1/7/2015,107.2,108.2,106.695,107.75,40105934,AAPL,110.494,0.461824555,4.79,1049.253731,-44.51490171,-0.765004222,-89.18490683,16122318.98,-3912601.675,0,96,-96,1.94,107.5483333,108.4016667,109.0533333,109.9066667,106.8966667,106.0433333,105.3916667,0.700996678,1071262705,191118181.3,1
1/8/2015,109.23,112.15,108.7,111.89,59364547,AAPL,110.429,0.460605477,0.12,484.6774194,-18.26252378,-0.606244552,4.885202066,50416847.16,-1443081.273,8,92,-84,4.4,110.9133333,113.1266667,114.3633333,116.5766667,109.6766667,107.4633333,106.2266667,0.924637681,1130627252,193399102.2,1
1/9/2015,112.67,113.25,110.21,112.01,53699527,AAPL,110.429,0.459660493,1.98,-1390.625,-17.50158529,-0.633583319,40.87367841,9892018.132,-927849.4818,4,88,-84,3.04,111.8233333,113.4366667,114.8633333,116.4766667,110.3966667,108.7833333,107.3566667,0.592105263,1184326779,193456694,1
1/12/2015,112.6,112.63,108.8,109.25,49650790,AAPL,109.955,0.456748997,4.66,-351.7786561,-35.00317058,-0.60448992,-14.24475773,-37983502.53,-2612197.348,0,84,-84,3.83,110.2266667,111.6533333,114.0566667,115.4833333,107.8233333,106.3966667,103.9933333,0.117493473,1134675989,192233265.9,-1
1/13/2015,111.43,112.8,108.91,110.22,67091928,AAPL,109.586,0.454292261,2.3,-320.2205882,-28.85225111,-0.516632715,1.135412036,-21904048.47,-3489099.672,0,80,-80,3.89,110.6433333,112.3766667,114.5333333,116.2666667,108.4866667,106.7533333,104.5966667,0.336760925,1201767917,192828956.3,1
1/14/2015,109.04,110.49,108.5,109.8,48956588,AAPL,109.314,0.45224188,0.58,-317.8832117,-31.51553583,-0.76119772,-44.00896324,15006793.31,-2648377.264,8,76,-68,1.99,109.5966667,110.6933333,111.5866667,112.6833333,108.7033333,107.6066667,106.7133333,0.653266332,1152811329,192642404.2,-1
1/15/2015,110,110.06,106.66,106.82,60013996,AAPL,108.958,0.449833942,2.51,-167.822736,-50.41217502,-1.273363418,-114.6027364,-54365619.91,-4999161.021,4,72,-68,3.4,107.8466667,109.0333333,111.2466667,112.4333333,105.6333333,104.4466667,102.2333333,0.047058824,1092797333,191013609,-1
1/16/2015,107.03,107.58,105.2,105.99,78513345,AAPL,108.624,0.447521522,0.26,-84.125,-55.67533291,-1.55794173,-160.6282569,-26391040.34,-5971519.171,0,68,-68,2.38,106.2566667,107.3133333,108.6366667,109.6933333,104.9333333,103.8766667,102.5533333,0.331932773,1014283988,190403554,-1
1/20/2015,107.84,108.9667,106.5,108.72,49899907,AAPL,108.871,0.447606277,-2.46,-182.2736031,-38.36398224,-1.646701498,-74.72642482,39918711.83,-3885599.58,44,64,-20,2.9767,108.0622333,109.6244667,110.5289333,112.0911667,107.1577667,105.5955333,104.6910667,0.899987838,1064183895,191688833.3,1
1/21/2015,108.95,111.06,108.27,109.55,48575897,AAPL,109.2,0.448028287,-1.8,-346.4646465,-29.28954424,-1.600093523,-18.79477175,-4004464.627,-3891002.537,40,60,-20,2.79,109.6266667,110.9833333,112.4166667,113.7733333,108.1933333,106.8366667,105.4033333,0.458781362,1112759792,192059675.7,1
1/22/2015,110.26,112.47,109.72,112.4,53796409,AAPL,109.665,0.449020364,-0.51,650.4950495,-5.964912281,-1.158772857,43.48522036,51057682.72,-1393335.025,36,56,-20,2.92,111.53,113.34,114.28,116.09,110.59,108.78,107.84,0.974545455,1166556201,193459217.2,1
1/23/2015,112.3,113.75,111.53,112.98,46464828,AAPL,109.774,0.448571009,-0.97,375.890411,-5.220338983,-0.752605989,81.40656069,14232469.84,-683071.167,32,52,-20,2.22,112.7533333,113.9766667,114.9733333,116.1966667,111.7566667,110.5333333,109.5366667,0.653153153,1213021029,193698982.3,1
1/26/2015,113.74,114.3626,112.8,113.1,55614979,AAPL,109.883,0.448123486,-3.85,202.0437956,-8.218660904,-0.601295015,100.6100011,-34260193.77,-2209304.013,28,48,-20,1.5626,113.4208667,114.0417333,114.9834667,115.6043333,112.4791333,111.8582667,110.9165333,0.191987713,1268636008,193758052.9,1
1/27/2015,112.42,112.48,109.03,109.14,95568749,AAPL,109.872,0.447161058,1.08,480.2083333,-33.99554763,-0.94695741,5.630198412,-89474509.93,-6175904.282,24,44,-20,4.07,110.2166667,111.4033333,113.6666667,114.8533333,107.9533333,106.7666667,104.5033333,0.031884058,1173067259,190411879.2,-1
1/28/2015,117.625,118.12,115.31,115.31,146477063,AAPL,110.381,0.448341895,-5.51,244.8412698,-14.69665272,-0.976149564,243.3666951,-146477063,-12553229.68,20,40,-20,8.98,116.2466667,117.1833333,119.0566667,119.9933333,114.3733333,113.4366667,111.5633333,0,1319544322,198692651.4,1
1/29/2015,116.32,119.19,115.56,118.9,84436432,AAPL,111.291,0.451150356,-12.08,256.2054208,-1.436354631,-0.575615397,266.6505126,70945211.46,-8757845.991,96,36,60,3.88,117.8833333,120.2066667,121.5133333,123.8366667,116.5766667,114.2533333,112.9466667,0.920110193,1403980754,201321450.2,1
1/30/2015,118.4,120,116.85,117.16,83745461,AAPL,112.325,0.454421596,-11.17,346.407767,-13.52380952,-0.241221599,202.3201077,-67262227.41,-11417136.06,96,32,64,3.15,118.0033333,119.1566667,121.1533333,122.3066667,116.0066667,114.8533333,112.8566667,0.098412698,1320235293,200095906.9,-1
2/2/2015,118.05,119.17,116.08,118.63,62739100,AAPL,113.589,0.458601306,-9.91,205.8635394,-6.523809524,0.198549075,159.8429138,40810870.87,-9043135.74,96,28,68,3.09,117.96,119.84,121.05,122.93,116.75,114.87,113.66,0.825242718,1382974393,200883090.9,1
2/3/2015,118.5,119.09,117.61,118.65,51915749,AAPL,114.582,0.461674452,-9.1,217.7935943,-6.428571429,1.078119153,135.6792424,21046925.27,-7675405.694,92,24,68,1.48,118.45,119.29,119.93,120.77,117.81,116.97,116.33,0.702702703,1434890142,200891843.5,1
2/4/2015,118.5,120.51,118.309,119.56,70149743,AAPL,115.583,0.46476639,-7.16,197.4385246,-4.416550442,2.314651892,124.5781122,9593399.656,-6890459.996,88,20,68,2.201,119.4596667,120.6103333,121.6606667,122.8113333,118.4093333,117.2586667,116.2083333,0.56837801,1505039885,201429865.1,1
2/5/2015,120.02,120.23,119.25,119.94,42246245,AAPL,116.337,0.466860815,-6.96,149.7713415,-2.649930265,3.282770552,107.6676421,17243365.31,-5793467.937,96,16,80,0.98,119.8066667,120.3633333,120.7866667,121.3433333,119.3833333,118.8266667,118.4033333,0.704081633,1547286130,201564137.2,1
2/6/2015,120.02,120.25,118.45,118.93,43706567,AAPL,116.932,0.468303001,-5.83,151.8547141,-7.345420735,4.111376317,85.80379611,-20396397.93,-6457237.482,92,12,80,1.8,119.21,119.97,121.01,121.77,118.17,117.41,116.37,0.266666667,1503579563,201196089.6,-1
2/9/2015,118.55,119.84,118.43,119.72,38889797,AAPL,117.594,0.470005817,-10.58,161,-3.672710367,4.500449398,80.11628824,32270257.09,-4696896.82,88,8,80,1.41,119.33,120.23,120.74,121.64,118.82,117.92,117.41,0.914893617,1542469360,201454417.5,1
2/10/2015,120.17,122.15,120.16,122.02,62008506,AAPL,118.882,0.474184241,-6.71,153.8091419,-0.561555076,4.84976558,97.80604282,53906892.15,-2033088.23,84,4,80,2.43,121.4433333,122.7266667,123.4333333,124.7166667,120.7366667,119.4533333,118.7466667,0.934673367,1604477866,202645693.5,1
2/11/2015,122.77,124.92,122.5,124.88,73561797,AAPL,119.839,0.477055501,-5.98,153.7660256,-0.154320988,5.114721727,114.3262416,71130002.06,1292506.783,96,0,96,2.9,124.1,125.7,126.52,128.12,123.28,121.68,120.86,0.983471074,1678039663,204369892.3,1
2/12/2015,126.06,127.48,125.57,126.46,74474466,AAPL,120.595,0.479130506,-9.3,149.7774481,-3.581460674,6.048829995,121.4218398,-5068942.712,1003349.988,96,28,68,2.6,126.5033333,127.4366667,128.4133333,129.3466667,125.5266667,124.5933333,123.6166667,0.465968586,1752514129,205312154.1,1
2/13/2015,127.28,127.28,125.65,127.08,54272219,AAPL,121.587,0.482121587,-8.45,147.9971388,-1.404494382,6.335994979,102.4876063,40953883.05,2819283.309,96,24,72,1.63,126.67,127.69,128.3,129.32,126.06,125.04,124.43,0.877300613,1806786348,205578236.5,1
2/17/2015,127.49,128.88,126.92,127.83,63152405,AAPL,122.507,0.484817114,-9.18,114.7137507,-3.514056225,6.452214585,96.6532884,-4510886.071,2486093.792,92,20,72,1.96,127.8766667,128.8333333,129.8366667,130.7933333,126.8733333,125.9166667,124.9133333,0.464285714,1869938753,205950949,1
2/18/2015,127.625,128.78,127.45,128.715,44891737,AAPL,123.5135,0.487839562,-9.155,120.5147333,-0.552208835,6.882945872,82.6602918,40503822.86,4214172.385,96,16,80,1.33,128.315,129.18,129.645,130.51,127.85,126.985,126.52,0.95112782,1914830490,206261746,1
2/19/2015,128.48,129.03,128.33,128.45,37362381,AAPL,124.4025,0.490382112,-8.51,131.5706806,-1.931401931,6.988236603,74.52664842,-24552421.8,2906599.922,92,12,80,0.7,128.6033333,128.8766667,129.3033333,129.5766667,128.1766667,127.9033333,127.4766667,0.171428571,1877468109,206184823.9,-1
2/20/2015,128.62,129.5,128.05,129.495,48948419,AAPL,125.358,0.493174613,-10.565,110.336441,-0.016393443,7.224370019,69.78073964,48610843.7,4984065.549,96,8,88,1.45,129.015,129.98,130.465,131.43,128.53,127.565,127.08,0.996551724,1926416528,206583041.9,1
2/23/2015,130.02,133,129.66,133,70974110,AAPL,126.765,0.497729163,-13.28,108.8726514,0,7.451439681,85.21022288,70974110,7983613.024,96,4,92,3.505,131.8866667,134.1133333,135.2266667,137.4533333,130.7733333,128.5466667,127.4333333,1,1997390638,208504075.6,1
2/24/2015,132.94,133.6,131.17,132.17,69228130,AAPL,128.01,0.501620786,-10.15,115.5695266,-4.132947977,7.478094576,78.48788502,-12250245.23,7063892.194,96,0,96,2.43,132.3133333,133.4566667,134.7433333,135.8866667,131.0266667,129.8833333,128.5966667,0.411522634,1928162508,208072050.4,-1
2/25/2015,131.56,131.6,128.15,128.79,74711746,AAPL,128.687,0.503264608,-3.91,159.4257855,-13.9017341,7.565239644,46.66108303,-46992605.46,4606778.665,96,0,96,4.02,129.5133333,130.8766667,132.9633333,134.3266667,127.4266667,126.0633333,123.9766667,0.185507246,1853450762,206161437.5,-1
2/26/2015,128.785,130.87,126.61,130.415,91287529,AAPL,129.2405,0.504432521,-3.955,152.3627685,-9.205202312,7.815566994,40.17421478,71787141.35,7660431.514,92,0,92,4.26,129.2983333,131.9866667,133.5583333,136.2466667,127.7266667,125.0383333,123.4666667,0.893192488,1944738291,207313252.4,1
2/27/2015,130,130.57,128.24,128.46,62014847,AAPL,129.4405,0.504214681,-1.38,167.4711438,-14.85549133,7.810614991,34.53797901,-50303888.77,5025689.683,88,12,76,2.33,129.09,129.94,131.42,132.27,127.61,126.76,125.28,0.094420601,1882723444,206383612.2,-1
3/2/2015,129.25,130.28,128.3,129.09,48096663,AAPL,129.6415,0.504004845,-1.26,168.6232657,-13.03468208,7.636872335,31.4749479,-9716497.576,4355590.262,84,8,76,1.98,129.2233333,130.1466667,131.2033333,132.1266667,128.1666667,127.2433333,126.1866667,0.398989899,1930820107,206619490.3,1
3/3/2015,128.96,129.52,128.09,129.36,37816283,AAPL,129.7945,0.503612134,-0.645,187.6021798,-12.25433526,7.301963302,25.38549667,29353897.99,5491876.977,80,4,76,1.43,128.99,129.89,130.42,131.32,128.46,127.56,127.03,0.888111888,1968636390,206698585.4,1
3/4/2015,129.1,129.56,128.32,128.54,31666340,AAPL,129.777,0.502560438,-0.09,298.0874317,-14.62427746,6.870833868,20.25065184,-20429896.77,4313614.534,76,0,76,1.24,128.8066667,129.2933333,130.0466667,130.5333333,128.0533333,127.5666667,126.8133333,0.177419355,1936970050,206497855.7,-1
3/5/2015,128.58,128.75,125.76,126.41,56517146,AAPL,129.573,0.500783869,3.085,-18660,-20.78034682,6.024475804,1.155915133,-31944473.83,2665519.608,72,0,72,2.99,126.9733333,128.1866667,129.9633333,131.1766667,125.1966667,123.9833333,122.2066667,0.217391304,1880452904,205561326.1,-1
3/6/2015,128.4,129.37,126.26,126.6,72842060,AAPL,129.2835,0.498690834,6.4,-1854.166667,-20.23121387,5.41593137,1.873242721,-56915178.71,-42693.9518,68,0,68,3.11,127.41,128.56,130.52,131.67,125.45,124.3,122.34,0.109324759,1953294964,205670811,1
3/9/2015,127.96,129.57,125.06,127.14,88528487,AAPL,128.6975,0.495482579,5.03,-1259.42029,-18.67052023,5.05995875,-4.325806146,-6870281.696,-353038.8493,64,4,60,4.51,127.2566667,129.4533333,131.7666667,133.9633333,124.9433333,122.7466667,120.4333333,0.461197339,2041823451,206048420.7,1
3/10/2015,126.41,127.22,123.8,124.51,68856582,AAPL,127.9315,0.491587122,4.28,-185.6123662,-26.2716763,4.364190183,-36.01747031,-40267007.02,-2167310.13,60,0,60,3.42,125.1766667,126.5533333,128.5966667,129.9733333,123.1333333,121.7566667,119.7133333,0.207602339,1972966869,204624063.2,-1
3/11/2015,124.75,124.77,122.11,122.24,68938974,AAPL,127.2765,0.488116758,8.175,-125.68438,-32.83236994,3.159328825,-71.76711565,-62200578.05,-4896095.035,56,0,56,2.66,123.04,123.97,125.7,126.63,121.31,120.38,118.65,0.04887218,1904027895,203367204.5,-1
3/12/2015,122.31,124.9,121.63,124.45,48362719,AAPL,126.68,0.484902352,4.01,-177.7998018,-26.44508671,2.035584883,-66.33907896,35051878.91,-3080278.038,52,0,52,3.27,123.66,125.69,126.93,128.96,122.42,120.39,119.15,0.862385321,1952390614,204241563.2,1
3/13/2015,124.4,125.3951,122.58,123.59,51827283,AAPL,126.193,0.482112262,5.5,-58.07651435,-28.93063584,1.346365747,-65.55001283,-14638155.91,-3605636.123,48,8,40,2.8151,123.8550333,125.1300667,126.6701333,127.9451667,122.3149667,121.0399333,119.4998667,0.358779439,1900563331,203883415.7,-1
3/16/2015,123.88,124.95,122.87,124.95,35874300,AAPL,125.779,0.479621739,4.41,-94.52908587,-25,0.436378419,-63.91578723,35874300,-1811093.572,44,4,40,2.08,124.2566667,125.6433333,126.3366667,127.7233333,123.5633333,122.1766667,121.4833333,1,1936437631,204278181,1
3/17/2015,125.9,127.32,125.65,127.04,51023104,AAPL,125.547,0.477844311,1.5,-509.4285714,-13.98773006,-0.270123763,-20.91877407,33913560.14,-187245.6756,40,0,40,2.37,126.67,127.69,128.34,129.36,126.02,125,124.35,0.832335329,1987460735,205131628.7,1
3/18/2015,127,129.16,126.37,128.47,65270945,AAPL,125.54,0.476931412,-2.06,-448.3290488,-7.530593034,-1.020851606,8.198395561,32986391.56,1320646.926,36,0,36,2.79,128,129.63,130.79,132.42,126.84,125.21,124.05,0.752688172,2052731680,205866337.8,1
3/19/2015,128.75,129.2451,127.4,127.495,45809490,AAPL,125.6485,0.476448301,-0.895,-903.626943,-9.74025974,-1.735122058,11.28302865,-41092237.22,-607211.4444,32,80,-48,1.8451,128.0467,128.6934,129.8918,130.5385,126.8483,126.2016,125.0032,0.051487724,2006922190,205518674.9,-1
3/20/2015,128.25,128.4,125.16,125.9,68695136,AAPL,125.5785,0.475286247,1.24,-253.6050157,-14.00255754,-2.241913707,-30.30815906,-37315876.35,-2275787.122,28,76,-48,3.24,126.4866667,127.8133333,129.7266667,131.0533333,124.5733333,123.2466667,121.3333333,0.228395062,1938227054,204659278.6,-1
3/23/2015,127.12,127.85,126.52,127.21,37709674,AAPL,125.5855,0.474426269,-2.7,-424.6511628,-7.719986915,-2.350499128,-2.295711011,1417656.917,-2107903.302,24,72,-48,1.95,127.1933333,127.8666667,128.5233333,129.1966667,126.5366667,125.8633333,125.2066667,0.518796992,1975936728,205051650.9,1
3/24/2015,127.23,128.04,126.56,126.69,32842304,AAPL,125.8035,0.474353022,-4.45,-493.5135135,-9.421000981,-2.466840053,3.477894959,-27072710.05,-3242667.245,20,68,-48,1.48,127.0966667,127.6333333,128.5766667,129.1133333,126.1533333,125.6166667,124.6733333,0.087837838,1943094424,204917400.4,-1
3/25/2015,126.54,126.82,123.38,123.38,51655177,AAPL,125.9175,0.473867704,1.07,-301.320132,-20.24860975,-2.7082782,-89.86908933,-51655177,-5443235.87,16,64,-48,3.44,124.5266667,125.6733333,127.9666667,129.1133333,122.2333333,121.0866667,118.7933333,0,1891439247,203567817.7,-1
3/26/2015,122.76,124.88,122.6,124.24,47572869,AAPL,125.8965,0.472887724,-0.65,-415.2542373,-17.43539418,-2.522732386,-95.34933749,20865293.42,-4247393.63,12,60,-48,2.28,123.9066667,125.2133333,126.1866667,127.4933333,122.9333333,121.6266667,120.6533333,0.719298246,1939012116,203899416.6,1
3/27/2015,124.57,124.7,122.91,123.25,39546151,AAPL,125.8625,0.471856402,1.7,-238.0462725,-20.67386326,-2.043727843,-87.52463625,-24523032.18,-5169013.564,8,56,-48,1.79,123.62,124.33,125.41,126.12,122.54,121.83,120.75,0.189944134,1899465965,203584295.1,-1
3/30/2015,124.05,126.4,124,126.37,47099670,AAPL,126.0045,0.471502955,0.67,665.5913978,-9.506002625,-1.697099759,-13.70622596,45922178.25,-2846686.663,4,52,-48,3.15,125.59,127.18,127.99,129.58,124.78,123.19,122.38,0.9875,1946565635,204776595.1,1
3/31/2015,126.09,126.49,124.355,124.43,42090553,AAPL,125.7435,0.469646509,4.04,565.2968037,-15.92026477,-1.031022801,-25.14489963,-39133371.29,-4496081.419,0,48,-48,2.135,125.0916667,125.8283333,127.2266667,127.9633333,123.6933333,122.9566667,121.5583333,0.035128806,1904475082,204130431.6,-1
4/1/2015,124.82,125.12,123.1,124.25,40621437,AAPL,125.3215,0.46720348,3.245,-5085,-16.51540249,-0.576114734,-57.83857897,5630694.238,-4035773.435,0,44,-44,2.02,124.1566667,125.2133333,126.1766667,127.2333333,123.1933333,122.1366667,121.1733333,0.569306931,1863853645,204071668.8,-1
4/2/2015,125.03,125.56,124.19,125.32,32220131,AAPL,125.104,0.465533065,0.58,649.7109827,-12.97763935,-0.584054873,-21.92686316,20931325.98,-2900905.28,0,40,-40,1.37,125.0233333,125.8566667,126.3933333,127.2266667,124.4866667,123.6533333,123.1166667,0.824817518,1896073776,204349137.9,1
4/6/2015,124.47,127.51,124.33,127.35,37193975,AAPL,125.249,0.465217024,-0.14,496.25,-6.265808346,-0.651549969,52.10981603,33451185.06,-1248537.537,0,36,-36,3.18,126.3966667,128.4633333,129.5766667,131.6433333,125.2833333,123.2166667,122.1033333,0.949685535,1933267751,204951625.7,1
4/7/2015,127.64,128.1218,125.98,126.01,35012268,AAPL,125.129,0.463919455,0.68,-953.3980583,-10.69627807,-0.756102903,82.99678191,-34031440.62,-2738669.495,0,32,-32,2.1418,126.7039333,127.4278667,128.8457333,129.5696667,125.2860667,124.5621333,123.1442667,0.01400691,1898255483,204583220.2,-1
4/8/2015,125.85,126.4,124.97,125.6,37329243,AAPL,125.02,0.462664954,-2.22,-292.3344948,-12.05186956,-0.620621539,13.22510766,-4437742.175,-2815900.072,16,28,-12,1.43,125.6566667,126.3433333,127.0866667,127.7733333,124.9133333,124.2266667,123.4833333,0.440559441,1860926240,204461761.7,-1
4/9/2015,125.85,126.58,124.66,126.56,32483974,AAPL,125.338,0.462983551,-2.32,-1000,-8.877801693,-0.628887265,21.83490896,31807224.54,-1242121.68,12,24,-12,1.92,125.9333333,127.2066667,127.8533333,129.1266667,125.2866667,124.0133333,123.3666667,0.989583333,1893410214,204710046.9,1
4/10/2015,125.95,127.21,125.26,127.1,40187953,AAPL,125.624,0.463185706,-3.85,824.1666667,-4.421768707,-0.612177062,50.83742981,35653927.53,434971.466,8,20,-12,1.95,126.5233333,127.7866667,128.4733333,129.7366667,125.8366667,124.5733333,123.8866667,0.943589744,1933598167,204881518.8,1
4/13/2015,128.37,128.57,126.61,126.85,36365123,AAPL,125.984,0.463653047,-0.48,-2383.333333,-5.816706121,-0.268355421,94.02008298,-27459378.59,-832953.5366,4,16,-12,1.96,127.3433333,128.0766667,129.3033333,130.0366667,126.1166667,125.3833333,124.1566667,0.12244898,1897233044,204809990.3,-1
4/14/2015,127,127.29,125.91,126.3,25524593,AAPL,125.977,0.462778045,-1.87,-2200,-7.676699357,-0.018511996,28.55800589,-11097649.13,-1299530.609,0,12,-12,1.38,126.5,127.09,127.88,128.47,125.71,125.12,124.33,0.282608696,1871708451,204699320,-1
4/15/2015,126.41,127.13,126.01,126.78,28970419,AAPL,126.212,0.462787892,-2.53,266.4705882,-6.053432533,0.440855605,36.14781904,10863907.13,-746647.0757,28,8,20,1.12,126.64,127.27,127.76,128.39,126.15,125.52,125.03,0.6875,1900678870,204809421.3,1
4/16/2015,126.28,127.1,126.11,126.17,28368987,AAPL,126.404,0.462636255,-0.85,424.8704663,-8.116334122,0.311066116,33.49989099,-24930321.91,-1845905.023,24,4,20,0.99,126.46,126.81,127.45,127.8,125.82,125.47,124.83,0.060606061,1872309883,204672924.4,-1
4/17/2015,125.55,126.14,124.46,124.75,51957046,AAPL,126.347,0.461573914,2.6,546.6666667,-12.91849848,0.271113756,-51.75070442,-34019494.4,-3308340.904,20,0,20,1.71,125.1166667,125.7733333,126.7966667,127.4533333,124.0933333,123.4366667,122.4133333,0.172619048,1820352837,204088165.7,-1
4/20/2015,125.57,128.12,125.17,127.6,47054310,AAPL,126.372,0.460830861,-1.59,644.7154472,-3.280351708,0.476631291,102.5662951,30465671.9,-1773158.504,16,0,16,3.37,126.9633333,128.7566667,129.9133333,131.7066667,125.8066667,124.0133333,122.8566667,0.823728814,1867407147,205163154,1
4/21/2015,128.1,128.2,126.67,126.91,32435057,AAPL,126.462,0.460319966,-1.31,319.7580645,-5.613797768,0.482926673,120.7535024,-22259352.84,-2704349.155,12,32,-20,1.53,127.26,127.85,128.79,129.38,126.32,125.73,124.79,0.156862745,1834972090,204987760.6,-1
4/22/2015,126.99,128.87,126.32,128.62,37654505,AAPL,126.764,0.4605842,-2.06,220.5949657,-0.836960161,0.337967299,163.9301942,30271268.73,-1205457.434,8,28,-20,2.55,127.9366667,129.5533333,130.4866667,132.1033333,127.0033333,125.3866667,124.4533333,0.901960784,1872626595,205495121.8,1
4/23/2015,128.3,130.42,128.14,129.67,45770902,AAPL,127.075,0.460884708,-2.57,221.1494253,-2.38701464,0.537115805,248.1399922,15658466.47,-438915.4377,4,24,-20,2.28,129.41,130.68,131.69,132.96,128.4,127.13,126.12,0.671052632,1918397497,205868776.3,1
4/24/2015,130.49,130.63,129.23,130.28,44525905,AAPL,127.393,0.46121115,-3.43,279.8634812,-1.10654442,0.921200413,222.4118832,22262952.5,592987.6504,96,20,76,1.4,130.0466667,130.8633333,131.4466667,132.2633333,129.4633333,128.6466667,128.0633333,0.75,1962923402,206078237.3,1
4/27/2015,132.31,133.13,131.15,132.65,96954207,AAPL,127.973,0.462487154,-6.35,159.186747,-1.406387343,1.201022682,284.3918617,49946106.64,2836311.241,96,16,80,2.85,132.31,133.47,134.29,135.45,131.49,130.33,129.51,0.757575758,2059877609,207841988.2,1
4/28/2015,134.455,134.54,129.57,130.56,118923970,AAPL,128.399,0.463191126,-3.78,213.1048387,-11.19864941,1.278621005,186.1558518,-71545808.91,-544694.2209,96,12,84,4.97,131.5566667,133.5433333,136.5266667,138.5133333,128.5733333,126.5866667,123.6033333,0.199195171,1940953639,205968252.1,-1
4/29/2015,130.16,131.59,128.3,128.64,63386083,AAPL,128.585,0.46302174,-2.47,462.0192308,-16.60101294,1.438789832,75.90665773,-50285008.09,-2805617.579,96,8,88,3.29,129.51,130.72,132.8,134.01,127.43,126.22,124.14,0.103343465,1877567556,205036103.8,-1
4/30/2015,127.5,127.88,124.58,125.15,83195423,AAPL,128.483,0.461804323,-0.4,-465.1282051,-26.42093416,1.569749532,-52.78014619,-54455185.96,-5153325.233,92,4,88,4.06,125.87,127.16,129.17,130.46,123.86,122.57,120.56,0.172727273,1794372133,202779014,-1
5/1/2015,126.1,130.13,125.3,128.95,58512638,AAPL,128.903,0.462470782,-1.35,612.8571429,-15.72875633,1.530831787,16.59230201,29922611.98,-3558964.45,88,0,88,4.98,128.1266667,130.9533333,132.9566667,135.7833333,126.1233333,123.2966667,121.2933333,0.755693582,1852884771,204555666.2,1
5/4/2015,129.5,130.57,128.26,128.7,50988278,AAPL,129.013,0.462031342,-1.79,536.25,-16.43218908,1.636539372,47.54270408,-31564172.1,-4831928.434,84,0,84,2.31,129.1766667,130.0933333,131.4866667,132.4033333,127.7833333,126.8666667,125.4733333,0.19047619,1801896493,204456813.4,-1
5/5/2015,128.15,128.4498,125.78,125.8,49271416,AAPL,128.902,0.460791952,2.82,-1264.285714,-24.592009,1.828776447,-34.6779139,-48533212.15,-6818350.421,80,8,72,2.92,126.6766,127.5732,129.3464,130.243,124.9034,124.0068,122.2336,0.007491198,1752625077,203346579.5,-1
5/6/2015,126.56,126.75,123.36,125.01,72141010,AAPL,128.541,0.458669352,4.66,-1068.103448,-26.8148565,1.818080731,-85.17135924,-1915248.053,-6595482.132,76,4,72,3.39,125.04,126.72,128.43,130.11,123.33,121.65,119.94,0.486725664,1680484067,202893547.7,-1
5/7/2015,124.77,126.08,124.02,125.26,43940895,AAPL,128.1,0.456276063,5.02,2478.431373,-26.11142375,1.788690079,-75.75267212,8958823.252,-5888468.251,72,0,72,2.06,125.12,126.22,127.18,128.28,124.16,123.06,122.1,0.601941748,1724424962,202981422.5,1
5/8/2015,126.68,127.62,126.11,127.62,55550382,AAPL,127.834,0.454525219,5.03,60750,-19.47101857,1.567413458,-16.54683315,55550382,-3095793.239,68,92,-24,2.36,127.1166667,128.1233333,128.6266667,129.6333333,126.6133333,125.6066667,125.1033333,1,1779975344,204028036.7,1
5/11/2015,127.39,127.56,125.625,126.32,42035757,AAPL,127.201,0.451484104,4.24,-2059.322034,-23.12886888,1.218682593,-33.09505609,-11839528.46,-3493235.749,64,88,-24,1.995,126.5016667,127.3783333,128.4366667,129.3133333,125.4433333,124.5666667,123.5083333,0.359173127,1737939587,203599839.9,-1
5/12/2015,125.6,126.88,124.82,125.865,48160032,AAPL,126.7315,0.449028506,2.775,-378.9473684,-24.40911649,0.87100956,-50.96322072,701359.6893,-3302572.32,60,84,-24,2.06,125.855,126.89,127.915,128.95,124.83,123.795,122.77,0.507281553,1689779555,203426369.2,-1
5/13/2015,126.15,127.19,125.87,126.01,34694235,AAPL,126.4685,0.447308684,-0.86,-260.5191257,-24.00112549,0.067749092,-36.51600447,-27334851.82,-4394948.661,56,80,-24,1.325,126.3566667,126.8433333,127.6766667,128.1633333,125.5233333,125.0366667,124.2033333,0.106060606,1724473790,203466337.9,1
5/14/2015,127.41,128.95,127.16,128.95,45203456,AAPL,126.8485,0.447863092,0,-892.1052632,-15.72875633,-0.459717937,19.67812849,45203456,-2140475.722,52,76,-24,2.94,128.3533333,129.5466667,130.1433333,131.3366667,127.7566667,126.5633333,125.9666667,1,1769677246,204521001.5,1
5/15/2015,129.07,129.49,128.21,128.77,38208034,AAPL,126.8305,0.44702292,-0.07,-244.7164948,-16.23522791,-0.698533684,31.57482657,-4776004.25,-2260272.473,48,72,-24,1.28,128.8233333,129.4366667,130.1033333,130.7166667,128.1566667,127.5433333,126.8766667,0.4375,1731469212,204467667.3,-1
5/18/2015,128.38,130.72,128.36,130.19,50882918,AAPL,126.9795,0.446776438,-4.39,-2950,-12.23972988,-0.384614985,70.43780234,28028726.02,-883499.8145,44,68,-24,2.36,129.7566667,131.1533333,132.1166667,133.5133333,128.7933333,127.3966667,126.4333333,0.775423729,1782352130,205028774.3,1
5/19/2015,130.69,130.88,129.64,130.07,44633240,AAPL,127.4065,0.447496028,-5.06,763.2867133,-4.664007364,-0.599661831,93.52393321,-13677928.39,-1465064.75,40,64,-24,1.24,130.1966667,130.7533333,131.4366667,131.9933333,129.5133333,128.9566667,128.2733333,0.346774194,1737718890,204987634.5,-1
5/20/2015,130,130.98,129.34,130.06,36454932,AAPL,127.9115,0.448481213,-4.8,222.3014257,-2.876797999,-0.828812002,85.71747342,-4445723.415,-1600549.234,36,60,-24,1.64,130.1266667,130.9133333,131.7666667,132.5533333,129.2733333,128.4866667,127.6333333,0.43902439,1701263958,204984831.8,-1
5/21/2015,130.07,131.63,129.83,131.39,39730364,AAPL,128.5245,0.449842351,-3.77,346.1065574,-0.735519461,-0.591916056,119.2239157,29135600.27,-203451.5298,32,56,-24,1.8,130.95,132.07,132.75,133.87,130.27,129.15,128.47,0.866666667,1740994322,205391116.5,1
5/22/2015,131.6,132.97,131.4,132.54,45595972,AAPL,129.0165,0.450783344,-6.22,249.8697917,-1.265822785,-0.220175768,160.2367857,20619834.47,743061.4703,28,52,-24,1.58,132.3033333,133.2066667,133.8733333,134.7766667,131.6366667,130.7333333,130.0666667,0.72611465,1786590294,205790198.3,1
5/26/2015,132.6,132.91,129.12,129.62,70697560,AAPL,129.3465,0.451140674,-3.755,251.1780105,-9.861642626,-0.002238513,81.55069714,-52043850.24,-1656343.607,24,48,-24,3.79,130.55,131.98,134.34,135.77,128.19,126.76,124.4,0.131926121,1715892734,204232654.4,-1
5/27/2015,130.34,132.26,130.05,132.045,45833246,AAPL,129.9645,0.452502575,-6.035,170.8599858,-2.722990874,0.154266466,111.064444,36915465.1,96920.42498,20,44,-24,2.64,131.4516667,132.8533333,133.6616667,135.0633333,130.6433333,129.2416667,128.4333333,0.902714932,1761725980,205090127.2,1
5/28/2015,131.86,131.95,131.1,131.78,30733309,AAPL,130.5415,0.453713285,-2.83,180.5214724,-3.503090963,0.468786642,111.3608183,18439985.4,930696.1057,16,40,-24,0.945,131.61,132.12,132.46,132.97,131.27,130.76,130.42,0.8,1730992671,205028448.7,-1
5/29/2015,131.23,131.45,129.9,130.28,50884452,AAPL,130.6745,0.453381578,-1.51,353.7593985,-7.91875184,0.957198613,63.48305408,-25934656.18,-290456.271,12,36,-24,1.88,130.5433333,131.1866667,132.0933333,132.7366667,129.6366667,128.9933333,128.0866667,0.24516129,1680108219,204449251,-1
6/1/2015,131.2,131.39,130.05,130.535,32112797,AAPL,130.851,0.453200998,-0.345,229.3001186,-7.168089491,1.546438844,60.31599459,-8866966.336,-680297.6376,8,32,-24,1.34,130.6583333,131.2666667,131.9983333,132.6066667,129.9266667,129.3183333,128.5866667,0.361940299,1712221016,204512106.1,1
6/2/2015,129.86,130.655,129.32,129.96,33667627,AAPL,130.828,0.452333369,0.11,236.019536,-8.860759494,1.793144511,35.38055341,-1387055.794,-712423.0083,4,28,-24,1.335,129.9783333,130.6366667,131.3133333,131.9716667,129.3016667,128.6433333,127.9666667,0.479400749,1678553389,204363801.9,-1
6/3/2015,130.66,130.94,129.9,130.12,30983542,AAPL,130.833,0.451565567,-0.06,235.5231144,-8.389755667,2.239087149,41.62852122,-17875120.38,-1492545.616,0,24,-24,1.04,130.32,130.74,131.36,131.78,129.7,129.28,128.66,0.211538462,1709536931,204401947.3,1
6/4/2015,129.58,130.58,128.91,129.36,38450118,AAPL,130.763,0.450539912,2.03,1643.902439,-10.62702384,2.360560206,10.32873793,-17728497.52,-2230543.43,68,20,48,1.67,129.6166667,130.3233333,131.2866667,131.9933333,128.6533333,127.9466667,126.9833333,0.269461078,1671086813,204177369.3,-1
6/5/2015,129.5,129.69,128.36,128.65,35626800,AAPL,130.489,0.448818979,3.89,-5616.666667,-12.71710333,2.365166349,-20.35947245,-20090300.75,-3042350.581,64,16,48,1.33,128.9,129.44,130.23,130.77,128.11,127.57,126.78,0.218045113,1635460013,203981829.5,-1
6/8/2015,128.9,129.21,126.83,127.8,52674786,AAPL,130.015,0.446420317,1.82,-222.5941423,-15.21931116,2.128781264,-54.8546305,-9738195.731,-3346707.179,60,12,48,2.38,127.9466667,129.0633333,130.3266667,131.4433333,126.6833333,125.5666667,124.3033333,0.407563025,1582785227,203633803.3,-1
6/9/2015,126.7,128.08,125.62,127.42,56075420,AAPL,129.795,0.444892884,4.625,-200.754717,-16.33794525,1.919649271,-87.39469087,25986170.24,-2013394.569,56,8,48,2.46,127.04,128.46,129.5,130.92,126,124.58,123.54,0.731707317,1526709807,203467068.9,-1
6/10/2015,127.92,129.34,127.85,128.88,39087250,AAPL,129.4785,0.44305345,2.9,-574.5762712,-12.04003533,1.544963497,-34.56692085,14952840.6,-1242202.061,52,4,48,1.92,128.69,129.53,130.18,131.02,128.04,127.2,126.55,0.691275168,1565797057,203914937.2,1
6/11/2015,129.18,130.18,128.475,128.59,35390887,AAPL,129.1595,0.441211978,1.69,-194.6428571,-12.89372976,1.362277121,-26.68653858,-30616749.75,-2577408.774,48,0,48,1.705,129.0816667,129.6883333,130.7866667,131.3933333,127.9833333,127.3766667,126.2783333,0.06744868,1530406170,203835302.2,-1
6/12/2015,128.185,128.33,127.11,127.17,36886246,AAPL,128.8485,0.439397384,3.365,-80.0744879,-17.07388873,0.737468053,-85.06355962,-33258090.66,-3971985.223,44,0,44,1.48,127.5366667,127.9633333,128.7566667,129.1833333,126.7433333,126.3166667,125.5233333,0.049180328,1493519924,203427973,-1
6/15/2015,126.1,127.24,125.71,126.92,43988946,AAPL,128.487,0.437419012,3.04,-159.2592593,-17.66440578,0.111193377,-122.8550813,25588341.14,-2628334.025,40,8,32,1.53,126.6233333,127.5366667,128.1533333,129.0666667,126.0066667,125.0933333,124.4766667,0.790849673,1449530978,203341496.3,-1
6/16/2015,127.03,127.85,126.37,127.6,31494131,AAPL,128.251,0.435875934,2.52,-57.48031496,-14.01082381,-0.183218875,-88.39880782,20854221.88,-1560945.12,36,4,32,1.48,127.2733333,128.1766667,128.7533333,129.6566667,126.6966667,125.7933333,125.2166667,0.831081081,1481025109,203510232.6,1
6/17/2015,127.72,127.88,126.74,127.3,32918071,AAPL,127.969,0.434183098,2.06,-57.03125,-14.11229135,-0.628893118,-84.1999205,-577510.0175,-1516243.525,32,0,32,1.14,127.3066667,127.8733333,128.4466667,129.0133333,126.7333333,126.1666667,125.5933333,0.49122807,1448107038,203432839,-1
6/18/2015,127.23,128.31,127.22,127.88,35407220,AAPL,127.821,0.432950588,0.77,-130.625,-11.00154083,-1.040989114,-62.48754473,7471248.257,-1107721.171,28,72,-44,1.09,127.8033333,128.3866667,128.8933333,129.4766667,127.2966667,126.7133333,126.2066667,0.605504587,1483514258,203594160.2,1
6/19/2015,127.71,127.82,126.4,126.6,54716887,AAPL,127.616,0.431524801,1.2,-73.18932656,-14.78851497,-1.529246924,-91.23336727,-39303679.39,-2843901.09,24,68,-44,1.48,126.94,127.48,128.36,128.9,126.06,125.52,124.64,0.14084507,1428797371,203046477.9,-1
6/23/2015,127.48,127.61,126.8792,127.03,30268863,AAPL,127.558,0.429873535,1.85,-120.7119741,-12.24170319,-1.885512973,-62.76174404,-17776951.29,-3278719.31,16,60,-44,0.7308,127.1730667,127.4669333,127.9038667,128.1977333,126.7361333,126.4422667,126.0053333,0.206349206,1432567853,203180464.8,-1
6/25/2015,128.86,129.2,127.5,127.5,31938100,AAPL,127.372,0.427813893,-0.33,-418.2608696,-8.595253368,-1.702695536,-12.38463055,-31938100,-5065646.758,8,52,-44,1.7,128.0666667,128.6333333,129.7666667,130.3333333,126.9333333,126.3666667,125.2333333,0,1455910608,203498384.4,-1
6/26/2015,127.67,127.99,126.51,126.75,44066841,AAPL,127.33,0.426953549,0.17,-458.0952381,-11.00064144,-1.817511019,-45.92285782,-29774892.57,-6188794.295,4,48,-44,1.48,127.0833333,127.6566667,128.5633333,129.1366667,126.1766667,125.6033333,124.6966667,0.162162162,1411843767,203239167.7,-1
6/29/2015,125.46,126.47,124.48,124.53,49161427,AAPL,127.091,0.425430491,3.07,-166.4359862,-18.12059012,-1.880580633,-116.2757594,-46691003.53,-8029803.806,0,44,-44,2.27,125.16,125.84,127.15,127.83,123.85,123.17,121.86,0.025125628,1362682340,202378115.5,-1
7/2/2015,126.43,126.69,125.77,126.44,27210952,AAPL,126.6595,0.421868013,0.16,-742.4657534,-10.90909091,-1.401082376,-40.73577141,12422391.13,-6235905.967,0,88,-88,0.92,126.3,126.83,127.22,127.75,125.91,125.38,124.99,0.72826087,1410080881,202945900.4,-1
7/6/2015,124.94,126.23,124.85,126,28060431,AAPL,126.5995,0.42096523,1.61,-589.1304348,-12.33766234,-1.226346806,-61.34461144,18706954,-5102139.605,0,84,-84,1.59,125.6933333,126.5366667,127.0733333,127.9166667,125.1566667,124.3133333,123.7766667,0.833333333,1382020450,202848252.6,-1
7/7/2015,125.89,126.15,123.77,125.69,46946811,AAPL,126.4075,0.419629874,1.34,-248.1675393,-13.34415584,-1.235335076,-81.5980404,28799304.23,-3561164.885,0,80,-80,2.38,125.2033333,126.6366667,127.5833333,129.0166667,124.2566667,122.8233333,121.8766667,0.806722689,1335073639,202732748.6,-1
7/8/2015,124.48,124.64,122.54,122.57,60761614,AAPL,125.9615,0.417448705,5.54,-100.2114165,-23.47402597,-1.13660119,-163.3268575,-59025567.89,-6082274.112,4,96,-92,3.15,123.25,123.96,125.35,126.06,121.86,121.15,119.76,0.014285714,1274312025,201224464.4,-1
7/9/2015,123.85,124.06,119.22,120.07,78595038,AAPL,125.1575,0.414089783,7.43,-53.26504481,-31.59090909,-1.28952827,-226.4962705,-50989342.83,-8123504.509,0,96,-96,4.84,121.1166667,123.0133333,125.9566667,127.8533333,118.1733333,116.2766667,113.3333333,0.175619835,1195716987,199621400.1,-1
7/14/2015,126.04,126.37,125.04,125.61,31768139,AAPL,124.7345,0.410664848,-0.185,-615.4929577,-13.6038961,-1.612158564,-11.3886571,-4538305.571,-4267867.734,12,88,-76,1.33,125.6733333,126.3066667,127.0033333,127.6366667,124.9766667,124.3433333,123.6466667,0.428571429,1266743860,202049071.3,-1
1/5/2016,105.75,105.85,102.41,102.71,55790992,AAPL,106.74,0.29304065,4.62,-56.70419652,-73.11594203,-5.822388089,-71.30557955,-46060005.02,-2474559.134,24,96,-72,3.44,103.6566667,104.9033333,107.0966667,108.3433333,101.4633333,100.2166667,98.02333333,0.087209302,435318035,180322695.7,-1
1/6/2016,100.56,102.37,99.87,100.7,68457388,AAPL,106.077,0.290812155,6.53,-56.58835546,-87.68115942,-5.815041858,-90.03606997,-23001682.37,-3407610.19,20,92,-72,2.84,100.98,102.09,103.48,104.59,99.59,98.48,97.09,0.332,366860647,178983007.7,-1
1/7/2016,98.68,100.13,96.43,96.45,81094428,AAPL,104.999,0.287448629,12.16,-31.49764943,-99.87357775,-5.494522123,-111.8238677,-80217731.48,-6898979.339,16,96,-80,4.27,97.67,98.91,101.37,102.61,95.21,93.97,91.51,0.005405405,285766219,175560452.4,-1
1/8/2016,98.55,99.11,96.76,96.96,70798016,AAPL,103.834,0.283864194,11.07,-43.26123128,-96.64981037,-5.416786397,-97.36005675,-58747289.87,-9255720.727,12,96,-84,2.66,97.61,98.46,99.96,100.81,96.11,95.26,93.76,0.085106383,356564235,175934812.1,1
1/11/2016,98.97,99.06,97.34,98.53,49739377,AAPL,102.884,0.280882417,8.29,-90.26666667,-83.95721925,-5.380945007,-78.20109276,19086040.01,-7967458.876,8,92,-84,2.1,98.31,99.28,100.03,101,97.56,96.59,95.84,0.691860465,406303612,176740204.2,1
1/12/2016,100.55,100.69,98.8399,99.96,49154227,AAPL,102.198,0.278632095,8.78,-93.62279512,-72.84615385,-5.603939331,-56.79357317,10364339.2,-7134195.327,4,88,-84,2.16,99.82996667,100.8200333,101.6800667,102.6701333,98.96993333,97.97986667,97.11983333,0.605426734,455457839,177453596.5,1
1/13/2016,100.32,101.19,97.3,97.39,62439631,AAPL,101.063,0.27516741,9.93,-70.12195122,-92.61538462,-5.618822912,-63.85872201,-59550393.58,-9516749.793,0,84,-84,3.89,98.62666667,99.95333333,102.5166667,103.8433333,96.06333333,94.73666667,92.17333333,0.023136247,393018208,175848255.9,-1
1/14/2016,97.96,100.48,95.74,99.52,63170127,AAPL,100.283,0.272682366,5.74,-84.15841584,-72.38860482,-5.500656632,-58.55964603,37582227.46,-7375887.19,0,80,-80,4.74,98.58,101.42,103.32,106.16,96.68,93.84,91.94,0.797468354,456188335,177229838.9,1
1/15/2016,96.2,97.71,95.36,97.13,79833891,AAPL,99.47,0.270109151,8.22,-70.18348624,-87.42004264,-5.754637676,-70.21049675,40426523.53,-5203050.34,0,96,-96,4.16,96.73333333,98.10666667,99.08333333,100.4566667,95.75666667,94.38333333,93.40666667,0.753191489,376354444,175312606.2,-1
1/19/2016,98.41,98.65,95.5,96.66,53087747,AAPL,98.601,0.267393428,6.05,-75.29527559,-90.7604833,-6.054030014,-60.25502546,-13988200,-5602375.324,0,96,-96,3.15,96.93666667,98.37333333,100.0866667,101.5233333,95.22333333,93.78666667,92.07333333,0.368253968,323266697,175055721.2,-1
1/20/2016,95.1,98.1897,93.42,96.79,72334416,AAPL,98.009,0.265433318,3.91,-49.0376569,-78.95065584,-6.090045345,-62.73737342,29880390.77,-3989522.32,0,92,-92,4.7697,96.13323333,98.84646667,100.9029333,103.6161667,94.07676667,91.36353333,89.30706667,0.706543388,395601113,175153005.2,1
1/21/2016,97.06,97.88,94.94,96.3,52161463,AAPL,97.569,0.263886914,0.15,-53.17604356,-81.15183246,-6.388613743,-53.84355951,-3903238.728,-3985600.339,4,96,-92,2.94,96.37333333,97.80666667,99.31333333,100.7466667,94.86666667,93.43333333,91.92666667,0.462585034,343439650,174888937.5,-1
1/22/2016,98.63,101.46,98.37,101.42,65800467,AAPL,98.066,0.264877001,-4.46,-285.9375,-41.2196914,-6.286211092,-11.0302682,64096895.04,-890941.4578,0,92,-92,5.16,100.4166667,102.4633333,103.5066667,105.5533333,99.37333333,97.32666667,96.28333333,0.987055016,409240117,178387363.1,1
1/25/2016,101.52,101.53,99.21,99.44,51794525,AAPL,98.314,0.265188731,-0.91,-184.2639594,-51.5687852,-6.092667768,-11.04121803,-41524920.91,-2737940.524,4,88,-84,2.32,100.06,100.91,102.38,103.23,98.59,97.74,96.27,0.099137931,357445592,177376190.2,-1
1/26/2016,99.93,100.88,98.07,99.99,75077002,AAPL,98.46,0.265227997,-0.03,-420.5882353,-47.14400644,-5.230482989,-11.50169315,27519328.14,-1362610.13,0,84,-84,2.81,99.64666667,101.2233333,102.4566667,104.0333333,98.41333333,96.83666667,95.60333333,0.683274021,432522594,177791439.1,1
1/27/2016,96.04,96.6289,93.34,93.42,133369674,AAPL,97.806,0.263106677,3.97,-157.1428571,-99.11406423,-4.708025676,-64.08457983,-126881441.5,-7068011.556,0,80,-80,6.65,94.46296667,95.58593333,97.75186667,98.87483333,92.29703333,91.17406667,89.00813333,0.024324242,299152920,169028175.2,-1
1/28/2016,93.79,94.52,92.39,94.09,55678825,AAPL,97.476,0.261859837,5.43,-513.1355932,-81.40043764,-4.560874981,-66.84574437,33198172.65,-5237730.456,20,96,-76,2.13,93.66666667,94.94333333,95.79666667,97.07333333,92.81333333,91.53666667,90.68333333,0.798122066,354831745,169427498.8,1
1/29/2016,94.79,97.34,94.35,97.34,64416504,AAPL,97.258,0.260927524,-0.21,3907.894737,-45.84245077,-4.460118918,-30.61810851,64416504,-2071628.89,16,96,-80,3.25,96.34333333,98.33666667,99.33333333,101.3266667,95.34666667,93.35333333,92.35666667,1,419248249,171652534.8,1
2/1/2016,96.47,96.71,95.4,96.43,40943541,AAPL,97.188,0.260388822,0.23,-632.3809524,-55.79868709,-4.034150509,-29.53324583,23440958.59,-911965.8226,12,92,-80,1.94,96.18,96.96,97.49,98.27,95.65,94.87,94.34,0.786259542,378304708,171269767,-1
2/2/2016,95.42,96.04,94.28,94.48,37357215,AAPL,96.97,0.259451741,2.31,-216.2408759,-77.13347921,-3.860703767,-44.11685057,-28866938.86,-2182646.415,8,88,-80,2.15,94.93333333,95.58666667,96.69333333,97.34666667,93.82666667,93.17333333,92.06666667,0.113636364,340947493,170514332.2,-1
2/3/2016,95,96.84,94.08,96.35,45964294,AAPL,96.926,0.258986171,-0.05,-1319.230769,-56.67396061,-3.349213436,-26.98069424,29643638.88,-735997.0836,4,84,-80,2.76,95.75666667,97.43333333,98.51666667,100.1933333,94.67333333,92.99666667,91.91333333,0.822463768,386911787,171424082.8,1
2/4/2016,95.86,97.33,95.19,96.6,46471652,AAPL,96.956,0.258718918,4.82,-405.4794521,-53.93873085,-2.821343067,-14.73895741,14766693.16,-31329.34528,0,80,-80,2.14,96.37333333,97.55666667,98.51333333,99.69666667,95.41666667,94.23333333,93.27666667,0.658878505,433383439,171544663.1,1
2/5/2016,96.52,96.92,93.69,94.02,46418064,AAPL,96.216,0.256406105,5.42,-380.7073955,-82.16630197,-2.233801703,-41.78261512,-36933258.35,-1708689.755,0,76,-76,3.23,94.87666667,96.06333333,98.10666667,99.29333333,92.83333333,91.64666667,89.60333333,0.102167183,386965375,170304926,-1
2/8/2016,93.13,95.7,93.04,95.01,54021375,AAPL,95.773,0.254890233,4.98,-777.5757576,-71.33479212,-1.621475424,-49.10071089,25995248.12,-449419.8513,0,72,-72,2.66,94.58333333,96.12666667,97.24333333,98.78666667,93.46666667,91.92333333,90.80666667,0.740601504,440986750,170873753.5,1
2/9/2016,94.29,95.94,93.93,94.99,44331195,AAPL,95.273,0.253229482,-1.57,-705.5555556,-71.5536105,-1.847897896,-41.28666105,2426085.299,-318715.0718,4,68,-64,2.01,94.95333333,95.97666667,96.96333333,97.98666667,93.96666667,92.94333333,91.95666667,0.527363184,396655555,170864421.6,-1
2/10/2016,95.92,96.35,94.1,94.27,42343601,AAPL,95.358,0.253113816,-0.18,-625.6157635,-79.43107221,-1.852064883,-41.23925188,-35945012.4,-1938092.223,0,64,-64,2.25,94.90666667,95.71333333,97.15666667,97.96333333,93.46333333,92.65666667,91.21333333,0.075555556,354311954,170543467.9,-1
2/11/2016,93.79,94.72,92.59,93.7,50074711,AAPL,95.319,0.252669858,3.64,-98.1865285,-85.66739606,-2.146126373,-74.32371869,2115832.859,-1753822.901,0,60,-60,2.13,93.67,94.75,95.8,96.88,92.62,91.54,90.49,0.521126761,304237243,170240693,-1
2/12/2016,94.19,94.5,93.01,93.99,40351381,AAPL,94.984,0.251450333,2.44,-144.4036697,-82.49452954,-1.668167272,-60.22753007,12728287.97,-1095545.135,44,56,-12,1.49,93.83333333,94.65666667,95.32333333,96.14666667,93.16666667,92.34333333,91.67666667,0.657718121,344588624,170365579.9,1
2/16/2016,95.02,96.85,94.61,96.64,49057916,AAPL,95.005,0.25117884,-2.16,-297.6119403,-49.94110718,-1.456358867,0.696130728,39859556.75,766050.4056,40,52,-12,2.86,96.03333333,97.45666667,98.27333333,99.69666667,95.21666667,93.79333333,92.97666667,0.90625,393646540,171748742.7,1
2/17/2016,96.67,98.21,96.15,98.12,44863243,AAPL,95.369,0.251812207,-1.77,243.6170213,-1.546391753,-1.6183761,39.70321677,40943153.81,2592282.378,36,48,-12,2.06,97.49333333,98.83666667,99.55333333,100.8966667,96.77666667,95.43333333,94.71666667,0.95631068,438509783,172435804,1
2/18/2016,98.84,98.89,96.091,96.26,39020983,AAPL,95.36,0.25145973,0.34,496.7741935,-40.46153846,-1.612891238,30.94497441,-34308910.03,914955.4509,32,44,-12,2.799,97.08033333,98.06966667,99.87933333,100.8686667,95.27066667,94.28133333,92.47166667,0.060378707,399488800,171696107.4,-1
2/19/2016,96,96.7599,95.8,96.04,35374173,AAPL,95.304,0.250984567,-2.02,-579.2307692,-45.23809524,-1.248984688,4.646786989,-17685243.9,69491.84386,28,40,-12,0.9599,96.19996667,96.59993333,97.15986667,97.55983333,95.64003333,95.24006667,94.68013333,0.250026044,364114627,171615260.6,-1
2/22/2016,96.31,96.9,95.92,96.88,34280758,AAPL,95.59,0.251406681,-1.87,1860,-31.9047619,-1.270514044,27.73616923,32881543.39,1560948.732,24,36,-12,0.98,96.56666667,97.21333333,97.54666667,98.19333333,96.23333333,95.58666667,95.25333333,0.979591837,398395385,171915092.3,1
2/23/2016,96.4,96.5,94.55,94.69,31942633,AAPL,95.558,0.250989946,0.3,3985.714286,-66.66666667,-1.254226083,-16.99757815,-27355998.52,246542.039,20,32,-12,2.33,95.24666667,95.94333333,97.19666667,97.89333333,93.99333333,93.29666667,92.04333333,0.071794872,366452752,171193020,-1
2/24/2016,93.98,96.38,93.32,96.1,36255745,AAPL,95.669,0.250951667,-1.83,-3164,-44.28571429,-0.993339543,-7.563465462,29620706.7,1581731.342,16,28,-12,3.06,95.26666667,97.21333333,98.32666667,100.2733333,94.15333333,92.20666667,91.09333333,0.908496732,402708497,171732893.2,1
2/25/2016,96.05,96.76,95.25,96.76,27582659,AAPL,95.918,0.251274276,-3.06,5200,-33.80952381,-0.864954117,39.69019405,27582659,2763591.69,12,24,-12,1.51,96.25666667,97.26333333,97.76666667,98.77333333,95.75333333,94.74666667,94.24333333,1,430291156,171922326.7,1
2/26/2016,97.2,98.0237,96.58,96.91,28991131,AAPL,96.239,0.251782713,-2.92,293.0795848,-31.42857143,-0.709940755,79.55775692,-15737583.55,1922629.179,8,20,-12,1.4437,97.17123333,97.76246667,98.61493333,99.20616667,96.31876667,95.72753333,94.87506667,0.228579345,459282287,171967269.5,1
2/29/2016,96.86,98.23,96.65,96.69,35216277,AAPL,96.509,0.252155687,-0.05,445.2380952,-34.92063492,-0.474427222,81.72347953,-33433174.37,315547.1998,4,16,-12,1.58,97.19,97.73,98.77,99.31,96.15,95.61,94.57,0.025316456,424066010,171887323.4,-1
3/1/2016,97.65,100.77,97.42,100.53,50407147,AAPL,96.898,0.25284815,-2.41,204.33213,-2.93398533,0.28810564,217.1766024,43184630.41,2264141.891,0,12,-12,4.08,99.57333333,101.7266667,102.9233333,105.0766667,98.37666667,96.22333333,95.02666667,0.928358209,474473157,173889220.6,1
3/2/2016,100.51,100.89,99.64,100.75,33169560,AAPL,97.161,0.253212221,-4.49,178.0864198,-1.686746988,0.950021388,224.9504444,25739578.56,3331207.195,0,8,-8,1.25,100.4266667,101.2133333,101.6766667,102.4633333,99.96333333,99.17666667,98.71333333,0.888,507642717,173961808.9,1
3/3/2016,100.58,101.7099,100.45,101.5,36955742,AAPL,97.685,0.254251381,-5.46,157.5641026,-2.301560324,1.343480104,219.6799499,24642050.05,4299881.87,96,4,92,1.2599,101.2199667,101.9899333,102.4798667,103.2498333,100.7300333,99.96006667,99.47013333,0.833399476,544598459,174236913.7,1
3/4/2016,102.37,103.75,101.37,103.01,46055100,AAPL,98.382,0.255737604,-6.13,149.7782705,-6.890130354,1.179596326,247.277069,17415794.12,4896059.699,96,0,96,2.38,102.71,104.05,105.09,106.43,101.67,100.33,99.29,0.68907563,590653559,174922068.4,1
3/7/2016,102.39,102.83,100.96,101.87,35915810,AAPL,98.881,0.25670346,-7.18,207.6481836,-18.02492809,1.296619913,170.1344799,-960315.7754,4629860.814,96,36,60,2.05,101.8866667,102.8133333,103.7566667,104.6833333,100.9433333,100.0166667,99.07333333,0.486631016,554737749,174524592.2,-1
3/8/2016,100.78,101.76,100.4,101.03,31561889,AAPL,99.515,0.258009784,-4.93,322.3367698,-26.07861937,1.653877097,109.406523,-2320727.132,4313924.998,92,32,60,1.47,101.0633333,101.7266667,102.4233333,103.0866667,100.3666667,99.70333333,99.00666667,0.463235294,523175860,174264339.1,-1
3/9/2016,101.31,101.58,100.27,101.12,27201683,AAPL,100.017,0.258971587,-4.36,194.8559671,-25.21572387,1.87216595,91.66366731,8098210.969,4485937.997,88,28,60,1.31,100.99,101.71,102.3,103.02,100.4,99.68,99.09,0.648854962,550377543,174288571,1
3/10/2016,101.41,102.24,100.15,101.17,33513577,AAPL,100.458,0.259772791,-4.26,185.5750487,-24.73633749,2.309140317,82.72530286,-801760.2153,4245588.078,84,24,60,2.09,101.1866667,102.2233333,103.2766667,104.3133333,100.1333333,99.09666667,98.04333333,0.488038278,583891120,174305142.2,1
3/11/2016,102.24,102.28,101.5,102.26,27408237,AAPL,100.993,0.260815126,-5.57,181.598513,-14.28571429,2.744678064,86.20422145,26002686.38,5234547.092,80,20,60,1.11,102.0133333,102.5266667,102.7933333,103.3066667,101.7466667,101.2333333,100.9666667,0.974358974,611299357,174600437,1
3/14/2016,101.91,102.91,101.78,102.52,25076062,AAPL,101.576,0.261976783,-1.99,128.0970626,-11.79290508,3.157859767,79.35646182,7766921.858,5349655.036,76,16,60,1.13,102.4033333,103.0266667,103.5333333,104.1566667,101.8966667,101.2733333,100.7666667,0.654867257,636375419,174664193.9,1
3/15/2016,103.96,105.18,103.85,104.58,40067734,AAPL,101.981,0.262685134,-3.83,125.9433962,-5.059021922,3.487298232,109.7537702,3916395.053,5284506.855,72,12,60,2.66,104.5366667,105.2233333,105.8666667,106.5533333,103.8933333,103.2066667,102.5633333,0.54887218,676443153,175469300.5,1
3/16/2016,104.61,106.31,104.59,105.97,38303493,AAPL,102.503,0.263693764,-4.47,123.8870793,-3.074141049,3.997766172,111.3675232,23160251.58,6097040.706,96,8,88,1.73,105.6233333,106.6566667,107.3433333,108.3766667,104.9366667,103.9033333,103.2166667,0.802325581,714746646,175978402.2,1
3/17/2016,105.52,106.47,104.96,105.8,34420705,AAPL,102.933,0.264462817,-2.79,126.6591676,-6.774519717,4.019711089,95.49631117,3875178.709,5996046.979,96,4,92,1.51,105.7433333,106.5266667,107.2533333,108.0366667,105.0166667,104.2333333,103.5066667,0.556291391,680325941,175923183.6,-1
3/18/2016,106.34,106.5,105.19,105.92,44205171,AAPL,103.224,0.264874733,-4.05,123.2936078,-5.888324873,3.989353572,83.14589529,5061660.802,5953574.88,96,0,96,1.31,105.87,106.55,107.18,107.86,105.24,104.56,103.93,0.557251908,724531112,175973321.8,1
3/21/2016,105.93,107.65,105.1401,105.91,35502678,AAPL,103.628,0.265572119,-4.88,140.1486989,-17.00879765,3.835284346,76.33834636,-13722119.58,5059225.132,96,0,96,2.5099,106.2333667,107.3266333,108.7432667,109.8365333,104.8167333,103.7234667,102.3068333,0.306745289,689028434,175969969.9,-1
3/22/2016,105.25,107.29,105.21,106.72,32444375,AAPL,104.197,0.266688354,-5.6,136.1809045,-10.75144509,3.515157131,69.00409187,14662361.78,5495731.343,96,24,72,2.08,106.4066667,107.6033333,108.4866667,109.6833333,105.5233333,104.3266667,103.4433333,0.725961538,721472809,176218104.6,1
3/23/2016,106.48,107.07,105.9,106.13,25703495,AAPL,104.698,0.26762536,-4.96,159.3952484,-17.57225434,3.506780942,59.86637957,-15597847.39,4536932.31,92,20,72,1.17,106.3666667,106.8333333,107.5366667,108.0033333,105.6633333,105.1966667,104.4933333,0.196581197,695769314,176076003.2,-1
3/24/2016,105.47,106.25,104.89,105.67,26132955,AAPL,105.148,0.26842757,-3.41,220.6766917,-22.89017341,3.717624326,42.42696827,3843081.618,4505393.642,88,16,72,1.36,105.6033333,106.3166667,106.9633333,107.6766667,104.9566667,104.2433333,103.5966667,0.573529412,669636359,175962734.9,-1
3/28/2016,106,106.19,105.06,105.19,19411372,AAPL,105.441,0.268827261,-2.67,176.8072289,-28.43930636,3.819034547,36.26511138,-14945038.62,3621283.085,84,12,72,1.13,105.48,105.9,106.61,107.03,104.77,104.35,103.64,0.115044248,650224987,175874559.9,-1
3/29/2016,104.89,107.79,104.88,107.68,31190083,AAPL,105.957,0.26979691,-3.1,125.7142857,-1.251422071,3.992896877,50.99295509,28832069.85,4767227.938,80,8,72,2.91,106.7833333,108.6866667,109.6933333,111.5966667,105.7766667,103.8733333,102.8666667,0.962199313,681415070,176612874.4,1
3/30/2016,108.65,110.42,108.6,109.56,45601149,AAPL,106.455,0.270723061,-3.59,120.2606635,-7.530647986,4.152791384,87.71018025,2505557.637,4664424.742,96,4,92,2.74,109.5266667,110.4533333,111.3466667,112.2733333,108.6333333,107.7066667,106.8133333,0.527472527,727016219,177409031.2,1
3/31/2016,109.72,109.9,108.88,108.99,25888449,AAPL,106.757,0.271149087,-3.19,129.1560102,-12.52189142,4.162179628,73.43814923,-20304665.88,3529466.077,96,0,96,1.02,109.2566667,109.6333333,110.2766667,110.6533333,108.6133333,108.2366667,107.5933333,0.107843137,701127770,177274343.2,-1
4/1/2016,108.78,110,108.2,109.99,25873950,AAPL,107.176,0.271870978,-4.07,129.4954722,-3.765323993,4.024392896,67.4696938,25586461.67,4532056.786,92,0,92,1.8,109.3966667,110.5933333,111.1966667,112.3933333,108.7933333,107.5966667,106.9933333,0.994444444,727001720,177511740.7,1
4/4/2016,110.42,112.19,110.27,111.12,37356204,AAPL,107.696,0.272847401,-5.21,126.5116279,-8.112206217,3.775151557,87.03925649,-4280398.375,4131490.642,88,0,88,2.2,111.1933333,112.1166667,113.1133333,114.0366667,110.1966667,109.2733333,108.2766667,0.442708333,764357924,177895525.6,1
4/5/2016,109.51,110.73,109.42,109.81,26578652,AAPL,108.086,0.273488853,-3.09,168.6424474,-18.04397271,3.532527118,60.66825223,-10753195.08,3454914.018,96,0,96,1.7,109.9866667,110.5533333,111.2966667,111.8633333,109.2433333,108.6766667,107.9333333,0.297709924,737779272,177582188.4,-1
4/6/2016,110.23,110.98,109.2,110.96,26404077,AAPL,108.51,0.274216432,-4.83,171.9438878,-9.325246399,3.294907512,60.56698145,25810726.96,4471087.334,92,0,92,1.78,110.38,111.56,112.16,113.34,109.78,108.6,108,0.988764045,764183349,177858708.7,1
4/7/2016,109.95,110.42,108.121,108.54,31801870,AAPL,108.751,0.274474463,-2.87,313.1386861,-27.67247915,3.248817019,35.82969396,-20209887.81,3349224.827,88,0,88,2.839,109.027,109.933,111.326,112.232,107.634,106.728,105.335,0.182253154,732381479,177165120.6,-1
4/8/2016,108.91,109.77,108.17,108.66,23581740,AAPL,109.05,0.274876649,-3.47,313.1386861,-26.76269901,3.117304508,29.12933613,-9137924.25,2781627.142,84,20,64,1.6,108.8666667,109.5633333,110.4666667,111.1633333,107.9633333,107.2666667,106.3633333,0.30625,755963219,177191192.2,1
4/11/2016,108.97,110.61,108.83,109.02,29407518,AAPL,109.433,0.275488026,-1.34,287.4598071,-24.03335861,3.132652682,35.07281069,-23129508.54,1603848.247,80,16,64,1.95,109.4866667,110.1433333,111.2666667,111.9233333,108.3633333,107.7066667,106.5833333,0.106741573,785370737,177288621.9,1
4/12/2016,109.34,110.5,108.66,110.44,27232325,AAPL,109.709,0.275834003,-0.88,256.7204301,-13.26762699,3.364163671,37.22403831,25456303.8,2688050.773,76,12,64,1.84,109.8666667,111.0733333,111.7066667,112.9133333,109.2333333,108.0266667,107.3933333,0.967391304,812603062,177643326.5,1
4/13/2016,110.8,112.34,110.8,112.04,33257316,AAPL,109.957,0.276113471,-3.05,188.6632826,-2.248875562,3.669879704,67.40831365,20299920.16,3488590.29,72,8,64,1.9,111.7266667,112.6533333,113.2666667,114.1933333,111.1133333,110.1866667,109.5733333,0.805194805,845860378,178125142.1,1
4/14/2016,111.62,112.39,111.33,112.1,25473923,AAPL,110.268,0.276548547,-2.11,174.3390358,-2.16579537,3.616822154,66.19816891,11535361.36,3854352.611,96,4,92,1.06,111.94,112.55,113,113.61,111.49,110.88,110.43,0.726415094,871334301,178138783.9,1
4/15/2016,112.11,112.3,109.73,109.85,46938969,AAPL,110.254,0.276166042,1.27,240.5579399,-18.96938013,3.261093391,36.16118398,-42555563.33,1744810.977,96,0,96,2.57,110.6266667,111.5233333,113.1966667,114.0933333,108.9533333,108.0566667,106.3833333,0.046692607,824395332,177196654.8,-1
4/18/2016,108.89,108.95,106.94,107.48,60821461,AAPL,109.89,0.274907565,2.33,-4360,-36.66915609,2.917320675,-19.07965555,-28141273,386352.6148,92,0,92,2.91,107.79,108.64,109.8,110.65,106.63,105.78,104.62,0.268656716,763573871,175884439.3,-1
4/19/2016,107.88,108,106.23,106.91,32384879,AAPL,109.6,0.273835215,4.05,-258.1132075,-40.92606423,2.471644413,-35.49479472,-7501582.141,27810.12592,88,0,88,1.77,107.0466667,107.8633333,108.8166667,109.6333333,106.0933333,105.2766667,104.3233333,0.384180791,731188992,175712692.2,-1
4/20/2016,106.64,108.09,106.06,107.13,30611030,AAPL,109.217,0.272536663,1.41,-379.5698925,-39.28304705,1.860136741,-38.19566769,1658725.764,101942.6549,84,0,84,2.03,107.0933333,108.1266667,109.1233333,110.1566667,106.0966667,105.0633333,104.0666667,0.527093596,761800022,175775683.8,1
4/21/2016,106.93,106.93,105.52,105.97,31552525,AAPL,108.96,0.271550809,2.69,-150.7462687,-47.94622853,1.494708126,-62.64921929,-11412615.43,-421446.3488,80,0,80,1.61,106.14,106.76,107.55,108.17,105.35,104.73,103.94,0.319148936,730247497,175434034.1,-1
4/22/2016,105.01,106.48,104.62,105.68,33683121,AAPL,108.662,0.270465964,3.34,-90.625,-50.1120239,1.018616034,-78.56217648,4708393.258,-188271.8212,76,28,48,1.86,105.5933333,106.5666667,107.4533333,108.4266667,104.7066667,103.7333333,102.8466667,0.569892473,696564376,175341856.1,-1
4/25/2016,105,105.65,104.51,105.08,28031588,AAPL,108.268,0.269145861,5.36,-104.2283298,-54.59297984,0.821695963,-96.77917485,-3.49E-07,-179714.0111,72,96,-24,1.17,105.08,105.65,106.22,106.79,104.51,103.94,103.37,0.5,668532788,175182706.3,-1
4/26/2016,103.91,105.3,103.91,104.35,56016165,AAPL,107.659,0.267297809,7.69,-57.18608169,-60.04480956,0.581476005,-109.618736,-20552693.63,-1105758.539,68,96,-28,1.39,104.52,105.13,105.91,106.52,103.74,103.13,102.35,0.316546763,612516623,174793557,-1
4/27/2016,96,98.71,95.68,97.82,114602142,AAPL,106.237,0.263433686,14.28,-35.26119403,-87.19329743,0.100294265,-278.6580529,47278111.39,1093508.275,64,96,-32,8.67,97.40333333,99.12666667,100.4333333,102.1566667,96.09666667,94.37333333,93.06666667,0.706270627,497914481,167621999.9,-1
4/28/2016,97.61,97.88,94.25,94.83,82242690,AAPL,104.51,0.258824039,15.02,-26.46420824,-96.80264609,-0.661268148,-248.6863301,-55961279.42,-1499891.165,60,96,-36,3.63,95.65333333,97.05666667,99.28333333,100.6866667,93.42666667,92.02333333,89.79666667,0.159779614,415671791,165108141.4,-1
4/29/2016,93.99,94.72,92.51,93.74,68531478,AAPL,102.899,0.25451277,13.74,-21.59685864,-93.81287726,-1.801595548,-223.8348246,7752429.638,-1079331.129,56,96,-40,2.32,93.65666667,94.80333333,95.86666667,97.01333333,92.59333333,91.44666667,90.38333333,0.556561086,347140313,164320423.2,-1
5/2/2016,93.965,94.08,92.4,93.64,48160104,AAPL,101.515,0.25077383,13.27,-11.19047619,-93.79689845,-3.102035201,-177.5894833,22933382.86,12155.87052,52,96,-44,1.68,93.37333333,94.34666667,95.05333333,96.02666667,92.66666667,91.69333333,90.98666667,0.738095238,298980209,164269047,-1
5/3/2016,94.2,95.74,93.68,95.18,56831277,AAPL,100.342,0.247570192,11.95,-10.79478055,-86.09304652,-4.204693818,-125.4887821,25932718.63,1190363.269,48,96,-48,2.1,94.86666667,96.05333333,96.92666667,98.11333333,93.99333333,92.80666667,91.93333333,0.72815534,355811486,165203692,1
5/4/2016,95.2,95.9,93.82,94.19,41025475,AAPL,99.048,0.244078805,11.78,-9.826912339,-91.04552276,-4.948335963,-109.1106936,-26429873.32,-65102.03064,44,92,-48,2.08,94.63666667,95.45333333,96.71666667,97.53333333,93.37333333,92.55666667,91.29333333,0.177884615,314786011,164776971.9,-1
5/5/2016,94,94.07,92.68,93.24,35890500,AAPL,97.775,0.240648393,12.44,-10.59602649,-95.77889447,-5.604261634,-107.0834008,-6971535.971,-379030.8461,40,88,-48,1.51,93.33,93.98,94.72,95.37,92.59,91.94,91.2,0.402877698,278895511,164414980.5,-1
5/6/2016,93.37,93.45,91.85,92.72,43699886,AAPL,96.479,0.23717252,12.36,-11.92411924,-94.9122807,-6.429187368,-96.50006797,3823740.025,-187995.8065,36,84,-48,1.6,92.67333333,93.49666667,94.27333333,95.09666667,91.89666667,91.07333333,90.29666667,0.54375,235195625,164171266,-1
5/9/2016,93,93.77,92.59,92.79,32936436,AAPL,95.25,0.233872702,11.56,-12.96033994,-94.21182266,-7.126813469,-77.66155162,-21771542.44,-1169066.108,32,96,-64,1.18,93.05,93.51,94.23,94.69,92.33,91.87,91.15,0.169491525,268132061,164196131.7,1
5/10/2016,93.33,93.57,92.11,93.42,33686836,AAPL,94.157,0.23091785,4.4,-16.3384391,-90.33251232,-7.791414706,-65.97557651,26764883.4,100658.8694,28,92,-64,1.46,93.03333333,93.95666667,94.49333333,95.41666667,92.49666667,91.57333333,91.03666667,0.897260274,301818897,164424849.3,1
5/11/2016,93.48,93.57,92.46,92.51,28719109,AAPL,93.626,0.229338129,2.32,-16.64190193,-95.62334218,-8.573541034,-56.57171273,-26131801.88,-1091725.71,24,88,-64,1.11,92.84666667,93.23333333,93.95666667,94.34333333,92.12333333,91.73666667,91.01333333,0.045045045,273099788,164145097.8,-1
5/12/2016,92.72,92.78,89.47,90.34,76314690,AAPL,93.177,0.227956621,3.4,-14.60234681,-94.88536155,-9.341011556,-61.58788922,-36197602.21,-2687447.369,20,84,-64,3.31,90.86333333,92.25666667,94.17333333,95.56666667,88.94666667,87.55333333,85.63666667,0.262839879,196785098,162354989.9,-1
5/13/2016,90,91.67,90,90.52,44392765,AAPL,92.855,0.226888622,3.12,-16.62087912,-93.5105068,-9.433776336,-52.95296953,-16746971.23,-3326516.635,16,96,-80,1.67,90.73,91.46,92.4,93.13,89.79,89.06,88.12,0.311377246,241177863,162443441.3,1
5/16/2016,92.39,94.39,91.65,93.88,61259756,AAPL,92.879,0.226672989,1.3,-55.20534862,-72.14150347,-9.0455819,-28.04296107,38455029.31,-1427355.456,12,92,-80,3.87,93.30666667,94.96333333,96.04666667,97.70333333,92.22333333,90.56666667,89.48333333,0.813868613,302437619,164717334.1,1
5/17/2016,94.55,94.7,93.01,93.49,46916939,AAPL,92.71,0.225989339,0.7,-133.4872979,-56.49350649,-8.48233445,-20.30633385,-20265896.73,-2283652.786,8,88,-80,1.69,93.73333333,94.45666667,95.42333333,96.14666667,92.76666667,92.04333333,91.07666667,0.284023669,255520680,164522429.9,-1
5/18/2016,94.16,95.21,93.89,94.56,42062391,AAPL,92.747,0.225809197,-1.32,-2537.037037,-39.47681332,-7.76759463,-10.62047606,637308.9545,-2150881.798,4,84,-80,1.72,94.55333333,95.21666667,95.87333333,96.53666667,93.89666667,93.23333333,92.57666667,0.507575758,297583071,165003837.1,1
5/19/2016,94.64,94.64,93.57,94.2,30442100,AAPL,92.843,0.225770816,-1.48,1489.130435,-26.43856921,-7.15249357,-10.07904141,5405606.542,-1807405.055,0,80,-80,1.07,94.13666667,94.70333333,95.20666667,95.77333333,93.63333333,93.06666667,92.56333333,0.588785047,267140971,164887940.8,-1
5/20/2016,94.64,95.43,94.52,95.22,32025968,AAPL,93.093,0.226106776,-2.43,498.1012658,-10.57542768,-6.35301197,2.144375489,17244752,-941397.9166,0,76,-76,1.23,95.05666667,95.59333333,95.96666667,96.50333333,94.68333333,94.14666667,93.77333333,0.769230769,299166939,165234718.8,1
5/23/2016,95.87,97.19,95.67,96.43,38018643,AAPL,93.457,0.226719436,-3.01,603.2,-9.844559585,-5.499090469,21.4613389,3.55E-07,-898607.1022,0,72,-72,1.97,96.43,97.19,97.95,98.71,95.67,94.91,94.15,0.5,337185582,165717837.5,1
5/24/2016,97.22,98.09,96.84,97.9,35140174,AAPL,93.905,0.227536015,-5.39,242.8571429,-2.204176334,-4.640761035,41.30880269,24457561.1,253945.9981,4,68,-64,1.66,97.61,98.38,98.86,99.63,97.13,96.36,95.88,0.848,372325756,166253522,1
5/25/2016,98.67,99.74,98.11,99.62,38642108,AAPL,94.616,0.228986534,-9.28,168.1818182,-1.168451801,-3.73378817,62.93136886,32952472.47,1740242.656,0,64,-64,1.84,99.15666667,100.2033333,100.7866667,101.8333333,98.57333333,97.52666667,96.94333333,0.926380368,410967864,166932423.1,1
5/26/2016,99.68,100.73,98.64,100.41,56331159,AAPL,95.623,0.231144438,-9.89,149.8049415,-2.841918295,-2.825191685,75.02325634,39081426.1,3437569.176,0,60,-60,2.09,99.92666667,101.2133333,102.0166667,103.3033333,99.12333333,97.83666667,97.03333333,0.846889952,467299023,167379136.8,1
5/27/2016,99.44,100.47,99.245,100.35,36341240,AAPL,96.606,0.233236465,-6.47,151.4550265,-3.374777975,-1.804151796,76.86509523,29221323.59,4609558.013,0,56,-56,1.225,100.0216667,100.7983333,101.2466667,102.0233333,99.57333333,98.79666667,98.34833333,0.902040816,430957783,167357421.1,-1
5/31/2016,99.6,100.4,98.82,99.86,42307212,AAPL,97.204,0.234397025,-6.37,168.0124224,-7.726465364,-0.432892906,71.34516052,13388358.23,5008594.386,0,52,-52,1.58,99.69333333,100.5666667,101.2733333,102.1466667,98.98666667,98.11333333,97.40666667,0.658227848,388650571,167150838.8,-1
6/1/2016,99.02,99.54,98.33,98.46,29173285,AAPL,97.701,0.235307366,-3.9,181.8487395,-20.1598579,0.941369467,57.50319841,-22904645.25,3739810.767,0,48,-48,1.53,98.77666667,99.22333333,99.98666667,100.4333333,98.01333333,97.56666667,96.80333333,0.107438017,359477286,166741840.2,-1
6/2/2016,97.6,97.84,96.63,97.72,40191600,AAPL,98.017,0.235779455,-3.52,146.6124661,-26.73179396,1.871273395,35.41140133,32219712.4,5034351.75,84,44,40,1.83,97.39666667,98.16333333,98.60666667,99.37333333,96.95333333,96.18666667,95.74333333,0.900826446,319285686,166439770.5,-1
6/3/2016,97.79,98.27,97.45,97.92,28504888,AAPL,98.389,0.236383736,-2.7,146.4864865,-26.18825722,2.510557323,44.67032461,4171447.024,4995128.808,80,40,40,0.82,97.88,98.31,98.7,99.13,97.49,97.06,96.67,0.573170732,347790574,166498110.4,1
6/6/2016,97.99,101.89,97.55,98.63,23292504,AAPL,98.73,0.23691366,-2.2,172.4210526,-31.8359375,2.880460683,73.94221189,-11699921.36,4236262.891,76,36,40,4.34,99.35666667,101.1633333,103.6966667,105.5033333,96.82333333,95.01666667,92.48333333,0.248847926,371083078,166667000.1,1
6/7/2016,99.25,99.87,98.96,99.03,22409450,AAPL,98.99,0.237249641,-1.13,155.0541516,-32.20720721,3.283056766,66.52218719,-18961842.31,3181803.564,96,32,64,1.24,99.28666667,99.61333333,100.1966667,100.5233333,98.70333333,98.37666667,97.79333333,0.076923077,393492528,166757883,1
6/8/2016,99.02,99.56,98.68,98.94,20848131,AAPL,99.094,0.23721284,0.68,171.6894977,-35.45673077,3.577929146,54.86364431,-8528780.864,2649504.272,92,28,64,0.88,99.06,99.44,99.94,100.32,98.56,98.18,97.68,0.295454545,372644397,166738935.9,-1
6/9/2016,98.5,99.99,98.46,99.65,26601354,AAPL,99.097,0.236937964,0.76,151.0091743,-26.92307692,3.852370791,53.03089393,14778530,3200823.623,88,24,64,1.53,99.36666667,100.2733333,100.8966667,101.8033333,98.74333333,97.83666667,97.21333333,0.777777778,399245751,166929829,1
6/10/2016,98.53,99.3457,98.48,98.83,31712936,AAPL,98.939,0.236279429,1.52,199.7229917,-41.51967436,3.863922215,33.67320195,-6070039.847,2779420.738,84,20,64,1.17,98.88523333,99.29046667,99.75093333,100.1561667,98.42476667,98.01953333,97.55906667,0.404297101,367532815,166668869.5,-1
6/13/2016,98.69,99.12,97.1,97.34,38020494,AAPL,98.638,0.235279809,2.52,659.3406593,-73.1511254,3.539576802,5.465540195,-28985921.17,1335541.56,80,16,64,2.02,97.85333333,98.60666667,99.87333333,100.6266667,96.58666667,95.83333333,94.56666667,0.118811881,329512321,166095657.6,-1
6/14/2016,97.32,98.475,96.75,97.46,31931944,AAPL,98.398,0.234428143,1,-1056.818182,-84.22053232,3.051146618,-4.585508885,-5645937.925,1018201.584,76,12,64,1.725,97.56166667,98.37333333,99.28666667,100.0983333,96.64833333,95.83666667,94.92333333,0.411594203,361444265,166135023.1,1
6/15/2016,97.82,98.41,97.03,97.14,29445227,AAPL,98.266,0.233833591,0.58,-118.1451613,-90.30418251,2.533031371,-9.873700888,-24751060.38,-153128.5054,72,8,64,1.38,97.52666667,98.02333333,98.90666667,99.40333333,96.64333333,96.14666667,95.26333333,0.079710145,331999038,166038342.6,-1
6/16/2016,96.45,97.75,96.07,97.55,31326815,AAPL,98.249,0.233513531,0.37,-89.16083916,-74.57044674,2.098094448,-24.13374361,23868049.52,938743.2232,68,4,64,1.68,97.12333333,98.17666667,98.80333333,99.85666667,96.49666667,95.44333333,94.81666667,0.880952381,363325853,166170564.1,1
6/17/2016,96.62,96.65,95.3,95.33,61008219,AAPL,97.99,0.232617275,3.3,-50.79681275,-99.5447648,1.718348821,-67.84857755,-58296742.6,-1753778.86,64,0,64,2.25,95.76,96.22,97.11,97.57,94.87,94.41,93.52,0.022222222,302317634,164782165.9,-1
6/20/2016,96,96.57,95.03,95.1,34411901,AAPL,97.637,0.231501801,3.93,-53.57142857,-98.97959184,1.277197058,-81.08146531,-31283546.36,-3096041.019,60,0,60,1.54,95.56666667,96.10333333,97.10666667,97.64333333,94.56333333,94.02666667,93.02333333,0.045454545,267905733,164699141.3,-1
6/21/2016,94.94,96.35,94.676,95.91,35546358,AAPL,97.325,0.230488711,3.03,-131.7647059,-82.89437205,0.81692201,-83.10438058,16860100.51,-2188943.677,56,0,56,1.674,95.64533333,96.61466667,97.31933333,98.28866667,94.94066667,93.97133333,93.26666667,0.737156511,303452091,165001902.1,1
6/22/2016,96.25,96.89,95.35,95.55,29219122,AAPL,96.986,0.229414429,4.1,-154.8387097,-87.8846687,0.43427302,-73.76538532,-21629739.66,-3072616.222,52,0,52,1.54,95.93,96.51,97.47,98.05,94.97,94.39,93.43,0.12987013,274232969,164892227.5,-1
6/23/2016,95.94,96.29,95.25,96.1,32240187,AAPL,96.631,0.22830761,2.73,-203.8461538,-80.26060438,-0.043271078,-69.67586746,20460118.67,-2002946.454,48,4,44,1.04,95.88,96.51,96.92,97.55,95.47,94.84,94.43,0.817307692,306473156,165077806.8,1
6/24/2016,92.91,94.655,92.65,93.4,75311356,AAPL,96.088,0.226756069,3.94,-57.36137667,-91.88311688,-0.543922302,-139.0897909,-18968695.65,-2774116.872,44,0,44,3.45,93.56833333,94.48666667,95.57333333,96.49166667,92.48166667,91.56333333,90.47666667,0.374064838,231161800,162961879,-1
6/27/2016,93,93.05,91.5,92.04,46622188,AAPL,95.558,0.225236359,5.42,-37.19599428,-93.63957597,-1.246650709,-169.3566213,-14137050.55,-3290613.857,40,96,-56,1.9,92.19666667,92.89333333,93.74666667,94.44333333,91.34333333,90.64666667,89.79333333,0.348387097,184539612,162283012.1,-1
6/28/2016,92.9,93.66,92.14,93.59,40444914,AAPL,95.171,0.224060504,3.55,-77.57009346,-75.3828033,-1.789361706,-118.5517408,36719724.55,-1471962.111,36,96,-60,1.62,93.13,94.12,94.65,95.64,92.6,91.61,91.08,0.953947368,224984526,162964124.8,1
6/29/2016,93.97,94.55,93.63,94.4,36531006,AAPL,94.897,0.223154742,3.15,-80.95238095,-65.84216726,-2.069347274,-74.76857926,24618721.43,-286021.9502,32,92,-60,0.96,94.19333333,94.75666667,95.11333333,95.67666667,93.83666667,93.27333333,92.91666667,0.836956522,261515532,163280292.3,1
6/30/2016,94.44,95.77,94.3,95.6,35836356,AAPL,94.702,0.222439534,-0.27,-168.7306502,-47.74207528,-2.268870301,-40.34170153,27547675.02,979146.0939,28,88,-60,1.47,95.22333333,96.14666667,96.69333333,97.61666667,94.67666667,93.75333333,93.20666667,0.884353741,297351888,163735839.2,1
7/1/2016,95.49,96.465,95.33,95.89,26026540,AAPL,94.758,0.222312402,-0.79,-395.862069,-42.38845144,-2.328508179,-17.08370306,-343963.0837,919004.7677,24,84,-60,1.135,95.895,96.46,97.03,97.595,95.325,94.76,94.19,0.49339207,323378428,163814790,1
7/6/2016,94.6,95.66,94.37,95.53,30949090,AAPL,94.709,0.221680868,0.02,-382.6086957,-41.67872648,-2.235518873,-24.70419942,24711288.91,2114055.786,16,76,-60,1.29,95.18666667,96.00333333,96.47666667,97.29333333,94.71333333,93.89666667,93.42333333,0.899224806,326622308,163730695.4,1
7/7/2016,95.7,96.5,95.62,95.94,25139558,AAPL,94.748,0.221515683,0.16,-382.6086957,-28.96,-2.017327852,4.275545438,-6856243.091,1706314.928,12,72,-60,0.97,96.02,96.42,96.9,97.3,95.54,95.14,94.66,0.363636364,351761866,163838590.5,1
1/4/2017,115.85,116.51,115.75,116.02,21118116,AAPL,116.556,0.237752449,0.93,381.9277108,-10.49924803,3.165311977,18.15053272,-6113138.842,2050115.311,84,20,64,0.76,116.0933333,116.4366667,116.8533333,117.1966667,115.6766667,115.3333333,114.9166667,0.355263158,686630199,177259464,-1
1/5/2017,115.92,116.8642,115.81,116.61,22193587,AAPL,116.522,0.237441422,0.45,264.7887324,-7.396695519,3.064499079,19.55550582,11490475.99,2479222.615,80,16,64,1.0542,116.4280667,117.0461333,117.4822667,118.1003333,115.9919333,115.3738667,114.9377333,0.758869285,708823786,177372325.7,1
1/6/2017,116.78,118.16,116.47,117.91,31751900,AAPL,116.607,0.237374682,-1.62,211.9617225,-1.30480167,2.894833987,37.95005454,22357846.75,3382796.439,76,12,64,1.69,117.5133333,118.5566667,119.2033333,120.2466667,116.8666667,115.8233333,115.1766667,0.852071006,740575686,177726304.5,1
1/9/2017,117.95,119.43,117.94,118.99,33561948,AAPL,116.877,0.237684244,-2.47,177.4834437,-2.153695546,2.645649401,63.14350202,13740126.36,3853584.163,96,8,88,1.52,118.7866667,119.6333333,120.2766667,121.1233333,118.1433333,117.2966667,116.6533333,0.704697987,774137634,178033716.1,1
1/10/2017,118.77,119.38,118.3,119.11,24462051,AAPL,117.136,0.237970641,-1.85,194.7368421,-1.566324033,2.312607995,62.60679697,12231025.5,4234376.951,96,4,92,1.08,118.93,119.56,120.01,120.64,118.48,117.85,117.4,0.75,798599685,178058385.8,1
1/11/2017,118.74,119.93,118.6,119.75,27588593,AAPL,117.385,0.238237058,-2.99,183.5714286,-0.860009556,2.122561176,71.40543328,20121003.92,4956496.358,92,0,92,1.33,119.4266667,120.2533333,120.7566667,121.5833333,118.9233333,118.0966667,117.5933333,0.864661654,826188278,178206624.4,1
1/12/2017,118.895,119.3,118.21,119.25,27086220,AAPL,117.634,0.238501389,-2.52,229.6803653,-3.248924988,1.840884066,55.27054972,24601245.69,5849439.51,96,4,92,1.54,118.92,119.63,120.01,120.72,118.54,117.83,117.45,0.95412844,799102058,178093529.6,-1
1/13/2017,119.11,119.62,118.81,119.04,26111948,AAPL,117.865,0.238727987,-3.22,182.9090909,-4.25226947,1.4991571,60.91165413,-11282940.49,5070694.964,92,0,92,0.81,119.1566667,119.5033333,119.9666667,120.3133333,118.6933333,118.3466667,117.8833333,0.283950617,772990110,178047546.3,-1
1/17/2017,118.34,120.24,118.22,120,34439843,AAPL,118.283,0.239331872,-3.85,165.5172414,-1.129943503,1.312627682,67.78412755,26256117.93,6033668.735,88,0,88,2.02,119.4866667,120.7533333,121.5066667,122.7733333,118.7333333,117.4666667,116.7133333,0.881188119,807429953,178325286.9,1
1/18/2017,120,120.5,119.71,119.99,23712961,AAPL,118.667,0.239865322,-3.97,183.8827839,-2.372093023,1.202690025,81.61158505,-6903773.456,5445603.181,96,0,96,0.79,120.0666667,120.4233333,120.8566667,121.2133333,119.6333333,119.2766667,118.8433333,0.35443038,783716992,178323310.8,-1
1/19/2017,119.4,120.09,119.37,119.78,25597291,AAPL,119.043,0.24038042,-3.17,166.2251656,-3.348837209,1.341414012,68.62592046,3555179.306,5359674.823,96,0,96,0.72,119.7466667,120.1233333,120.4666667,120.8433333,119.4033333,119.0266667,118.6833333,0.569444444,758119701,178278511.9,-1
1/20/2017,120.45,120.45,119.7346,120,32597892,AAPL,119.382,0.240819943,-2.09,160.2446483,-2.325581395,1.423554143,76.90127408,-8411477.304,4733713.363,92,0,92,0.7154,120.0615333,120.3884667,120.7769333,121.1038667,119.6730667,119.3461333,118.9576667,0.370981269,790717593,178338384.4,1
1/23/2017,120,120.81,119.77,120.08,22050218,AAPL,119.599,0.241013572,-1.09,124.8826291,-3.347088492,1.669380866,77.87506915,-8904895.731,4113776.586,88,48,40,1.04,120.22,120.67,121.26,121.71,119.63,119.18,118.59,0.298076923,812767811,178353084.6,1
1/24/2017,119.55,120.1,119.5,119.97,23211038,AAPL,119.697,0.240967914,-0.86,130.6282723,-3.851444292,1.861343477,57.33414802,13152921.53,4524646.811,96,44,52,0.6,119.8566667,120.2133333,120.4566667,120.8133333,119.6133333,119.2566667,119.0133333,0.783333333,789556773,178331822,-1
1/25/2017,120.42,122.1,120.28,121.88,32586673,AAPL,119.974,0.241284012,-2.13,117.7474403,-0.952380952,1.984786637,99.28490359,24708576.23,5442098.148,92,40,52,2.13,121.42,122.56,123.24,124.38,120.74,119.6,118.92,0.879120879,822143446,178850622.9,1
1/26/2017,121.67,122.44,121.6,121.94,26337576,AAPL,120.193,0.241483152,-2.69,119.5121951,-2.133105802,1.987216367,102.8175569,-5016681.143,4966699.089,96,36,60,0.84,121.9933333,122.3866667,122.8333333,123.2266667,121.5466667,121.1533333,120.7066667,0.404761905,848481022,178863588.5,1
1/27/2017,122.14,122.35,121.6,121.95,20562944,AAPL,120.463,0.241783262,-2.91,125.7425743,-2.090443686,2.026230212,87.30473939,-1370862.933,4678628.088,96,32,64,0.75,121.9666667,122.3333333,122.7166667,123.0833333,121.5833333,121.2166667,120.8333333,0.466666667,869043966,178865274.8,1
1/30/2017,120.93,121.63,120.66,121.63,30377503,AAPL,120.722,0.242059649,-1.63,151.5151515,-3.455631399,1.997704728,59.20252998,30377503,5846758.766,92,28,64,1.29,121.3066667,121.9533333,122.2766667,122.9233333,120.9833333,120.3366667,120.0133333,1,838666463,178785563.5,-1
1/31/2017,121.15,121.39,120.62,121.35,49200993,AAPL,120.857,0.242087391,-1.36,173.2142857,-4.650170648,2.045914694,47.7838494,44089201.52,7585051.618,88,24,64,1.01,121.12,121.62,121.89,122.39,120.85,120.35,120.08,0.948051948,789465470,178672299.7,-1
2/1/2017,127.03,130.49,127.01,128.75,111985040,AAPL,121.733,0.243604249,-8.97,118.2222222,-5.525563671,2.279031145,248.6195235,-4.57E-07,7240276.545,84,20,64,9.14,128.75,130.49,132.23,133.97,127.01,125.27,123.53,0.5,901450510,185501218.5,1
2/2/2017,127.975,129.39,127.78,128.53,33710411,AAPL,122.608,0.245113882,-8.53,114.6551724,-6.224198158,2.425221153,190.319013,-2303195.783,6806482.348,96,16,80,1.61,128.5666667,129.3533333,130.1766667,130.9633333,127.7433333,126.9566667,126.1333333,0.465838509,867740099,185443616.2,-1
2/3/2017,128.31,129.19,128.16,129.08,24507301,AAPL,123.516,0.246685384,-9,111.4541833,-4.47761194,2.667045697,157.1299066,19272731.85,7373130.053,92,12,80,1.03,128.81,129.46,129.84,130.49,128.43,127.78,127.4,0.893203883,892247400,185548486.8,1
2/6/2017,129.13,130.5,128.9,130.29,26845924,AAPL,124.537,0.24847855,-10.32,111.1758989,-0.666666667,2.979962778,148.575088,19798868.95,7937936.367,88,8,80,1.6,129.8966667,130.8933333,131.4966667,132.4933333,129.2933333,128.2966667,127.6933333,0.86875,919093324,185800141.3,1
2/7/2017,130.54,132.09,130.45,131.53,38183841,AAPL,125.693,0.250536162,-9.65,109.8786828,-1.692354186,3.34348709,146.9920173,12107071.54,8127442.511,96,4,92,1.8,131.3566667,132.2633333,132.9966667,133.9033333,130.6233333,129.7166667,128.9833333,0.658536585,957277165,186163545.8,1
2/8/2017,131.35,132.22,131.22,132.04,23004072,AAPL,126.709,0.252311167,-10.1,107.5856444,-0.541842264,3.710610301,129.5387567,14722606.08,8427222.673,96,0,96,1,131.8266667,132.4333333,132.8266667,133.4333333,131.4333333,130.8266667,130.4333333,0.82,980281237,186252742.7,1
2/9/2017,131.65,132.445,131.12,132.42,28349859,AAPL,127.757,0.254144683,-10.47,107.4879227,-0.074749589,4.188566556,110.9034181,27280053,9284169.506,96,0,96,1.325,131.995,132.87,133.32,134.195,131.545,130.67,130.22,0.981132075,1008631096,186334331.2,1
2/10/2017,132.46,132.94,132.05,132.12,20065458,AAPL,128.774,0.255910627,-10.49,110.2159468,-2.416028285,4.452353941,98.35094095,-16909093.82,8093566.627,96,0,96,0.89,132.37,132.69,133.26,133.58,131.8,131.48,130.91,0.078651685,988565638,186288872.5,-1
2/13/2017,133.08,133.82,132.75,133.29,23035421,AAPL,129.94,0.257967545,-11.94,108.4084084,-1.522113728,4.831432586,93.87405005,215284.3084,7735462.886,96,0,96,1.7,133.2866667,133.8233333,134.3566667,134.8933333,132.7533333,132.2166667,131.6833333,0.504672897,1011601059,186492864.7,1
2/14/2017,133.47,135.09,133.25,135.02,33226223,AAPL,131.307,0.260417947,-6.27,108.5235921,-0.193959546,5.403892994,91.43774831,30698140.82,8779220.973,96,0,96,1.84,134.4533333,135.6566667,136.2933333,137.4966667,133.8166667,132.6133333,131.9766667,0.961956522,1044827282,186924115.1,1
2/15/2017,135.52,136.27,134.62,135.51,35623100,AAPL,131.983,0.261500218,-6.98,108.2535004,-2.039173598,6.188460534,88.42310157,2806668.485,8507741.315,96,8,88,1.65,135.4666667,136.3133333,137.1166667,137.9633333,134.6633333,133.8166667,133.0133333,0.539393939,1080450382,187053394.6,1
2/16/2017,135.67,135.9,134.8398,135.345,22584555,AAPL,132.6645,0.262589523,-6.265,109.5931318,-2.481888919,7.120226312,75.04347327,-1060847.801,8072805.446,96,4,92,1.0602,135.3616,135.8834,136.4218,136.9436,134.8232,134.3014,133.763,0.476513865,1057865827,187025895.1,-1
2/17/2017,135.1,135.83,135.1,135.72,22198197,AAPL,133.3285,0.263641662,-5.43,106.848829,-1.475717735,7.159937465,66.17804807,15508329.41,8410783.808,92,0,92,0.73,135.55,136,136.28,136.73,135.27,134.82,134.54,0.849315068,1080064024,187087399.6,1
2/21/2017,136.23,136.75,135.98,136.7,24507156,AAPL,133.9695,0.264647155,-5.17,104.4625407,-0.132450331,7.257844013,64.0128258,21324408.47,8997766.747,88,4,84,1.03,136.4766667,136.9733333,137.2466667,137.7433333,136.2033333,135.7066667,135.4333333,0.935064935,1104571180,187264359.6,1
2/22/2017,136.43,137.12,136.11,137.11,20836932,AAPL,134.5275,0.265487312,-5.07,108.1937799,-0.026232949,7.316813282,56.33723833,20424319.49,9517155.508,96,0,96,1.01,136.78,137.45,137.79,138.46,136.44,135.77,135.43,0.99009901,1125408112,187326855.2,1
2/23/2017,137.38,137.48,136.3,136.53,20788186,AAPL,134.9765,0.266109875,-4.11,113.0625,-2.468814969,7.28941202,50.76188268,-12684316.88,8507997.672,96,4,92,1.18,136.77,137.24,137.95,138.42,136.06,135.59,134.88,0.194915254,1104619926,187238917.4,-1
2/24/2017,135.91,136.66,135.28,136.66,21776585,AAPL,135.4005,0.266681623,-4.54,113.7862797,-2.130977131,7.117695441,40.70849906,21776585,9111115.278,96,0,96,1.38,136.2,137.12,137.58,138.5,135.74,134.82,134.36,1,1126396511,187259652.5,1
2/27/2017,137.14,137.435,136.28,136.93,20257426,AAPL,135.8815,0.267363495,-3.64,115.7379518,-1.429313929,6.885085545,41.18455639,2543140.061,8812570.95,92,8,84,1.155,136.8816667,137.4833333,138.0366667,138.6383333,136.3283333,135.7266667,135.1733333,0.562770563,1146653937,187299675.2,1
2/28/2017,137.08,137.435,136.7,136.99,23482860,AAPL,136.2515,0.267826211,-1.97,119.1391941,-1.273388773,6.628604375,36.83605391,-4952167.755,8186901.009,88,4,84,0.735,137.0416667,137.3833333,137.7766667,138.1183333,136.6483333,136.3066667,135.9133333,0.394557823,1170136797,187309964.9,1
3/1/2017,137.89,140.15,137.595,139.79,36414585,AAPL,136.7285,0.268501693,-4.28,113.483871,-0.874848117,6.506201907,50.21811052,26152940.69,9003539.176,84,0,84,3.16,139.1783333,140.7616667,141.7333333,143.3166667,138.2066667,136.6233333,135.6516667,0.859099804,1206551382,188054258.9,1
3/2/2017,140,140.2786,138.76,138.96,26210984,AAPL,137.0735,0.268915771,-3.615,128.6697248,-3.194391283,6.218902646,48.29733555,-19306997.7,7716696.591,96,0,96,1.5186,139.3328667,139.9057333,140.8514667,141.4243333,138.3871333,137.8142667,136.8685333,0.13170025,1180340398,187898631.8,-1
3/3/2017,138.78,139.83,138.59,139.78,21571121,AAPL,137.517,0.269521955,-4.06,120.5613577,-1.207889802,5.84200022,45.18830426,19831514.47,8267370.131,96,12,84,1.24,139.4,140.21,140.64,141.45,138.97,138.16,137.73,0.959677419,1201911519,188025922.5,1
3/6/2017,139.365,139.77,138.5959,139.34,21750044,AAPL,137.879,0.269966543,-2.64,133.3057851,-2.273817426,5.391584702,39.72373988,5818660.097,8156065.129,92,8,84,1.1841,139.2353,139.8747,140.4094,141.0488,138.7006,138.0612,137.5265,0.63376203,1180161475,187957457.7,-1
3/7/2017,139.06,139.98,138.79,139.52,17446297,AAPL,138.161,0.270254273,-2.41,144.7777778,-1.837756125,4.96828354,38.6297388,3958403.521,7965262.329,88,4,84,1.19,139.43,140.07,140.62,141.26,138.88,138.24,137.69,0.613445378,1197607772,187979994.9,1
3/8/2017,138.95,139.8,138.82,139,18707236,AAPL,138.35,0.270359152,-2.47,172.6361032,-3.097488771,4.460240327,33.84377177,-11835190.12,7065241.763,84,0,84,0.98,139.2066667,139.5933333,140.1866667,140.5733333,138.6133333,138.2266667,137.6333333,0.183673469,1178900536,187910271.8,-1
3/9/2017,138.74,138.79,137.05,138.68,22155904,AAPL,138.565,0.270513341,-2.02,180.6596702,-3.872708861,3.782597895,19.47841831,19354582.8,7623848.174,80,0,80,1.95,138.1733333,139.2966667,139.9133333,141.0366667,137.5566667,136.4333333,135.8166667,0.936781609,1156744632,187859265.4,-1
3/10/2017,139.25,139.3571,138.64,139.14,19612801,AAPL,138.813,0.270731713,-2.21,178.6549708,-2.758329982,3.508233389,28.4665559,7737360.763,7629007.837,76,0,76,0.7171,139.0457,139.4514,139.7628,140.1685,138.7343,138.3286,138.0172,0.697252824,1176357433,187924320.8,1
3/13/2017,138.85,139.43,138.82,139.2,17421717,AAPL,139.04,0.270908609,-2.21,207.6,-2.612976215,3.303193661,27.33277684,4284028.77,7476963.334,72,0,72,0.61,139.15,139.48,139.76,140.09,138.87,138.54,138.26,0.62295082,1193779150,187931833.4,1
3/14/2017,139.3,139.65,138.84,138.99,15309065,AAPL,139.24,0.27103206,0.8,254.2553191,-3.121714399,3.115790978,25.34870917,-9639040.926,6698963.14,68,0,68,0.81,139.16,139.48,139.97,140.29,138.67,138.35,137.86,0.185185185,1178470085,187908737.9,-1
3/15/2017,139.41,140.7501,139.025,140.46,25691774,AAPL,139.307,0.270900429,-1.5,159.0330789,-0.694848635,3.011631446,39.47468888,17050902.59,7169505.843,64,0,64,1.7601,140.0783667,141.1317333,141.8034667,142.8568333,139.4066333,138.3532667,137.6815333,0.831835836,1204161859,188180461.8,1
3/16/2017,140.72,141.02,140.26,140.69,19231998,AAPL,139.48,0.270974186,-0.91,157.5682382,-0.785340314,2.997267278,48.92183504,2530526.053,6958643.125,96,4,92,0.76,140.6566667,141.0533333,141.4166667,141.8133333,140.2933333,139.8966667,139.5333333,0.565789474,1223393857,188211953.7,1
3/17/2017,141,141,139.89,139.99,43884952,AAPL,139.501,0.27075272,-0.65,198.6928105,-2.451213708,2.615488388,38.85131117,-35977753.44,5006988.735,96,0,96,1.11,140.2933333,140.6966667,141.4033333,141.8066667,139.5866667,139.1833333,138.4766667,0.09009009,1179508905,187993605.1,-1
3/20/2017,140.4,141.5,140.23,141.46,21542038,AAPL,139.713,0.270902775,-1.94,167.5615213,-0.094117647,2.397641146,52.26001306,20185059.23,5696901.031,92,0,92,1.51,141.0633333,141.8966667,142.3333333,143.1666667,140.6266667,139.7933333,139.3566667,0.968503937,1201050943,188219812.7,1
3/21/2017,142.11,142.8,139.73,139.84,39529912,AAPL,139.745,0.270702279,-0.84,9380,-6.757990868,2.001405533,43.28310576,-36697149.58,3769898.73,96,0,96,3.07,140.79,141.85,143.86,144.92,138.78,137.72,135.71,0.035830619,1161521031,187767116.1,-1
3/22/2017,139.845,141.6,139.76,141.42,25860165,AAPL,139.987,0.270909303,-2.74,254.8780488,-3.150684932,1.765718495,45.48607585,20800567.5,4544020.038,96,0,96,1.84,140.9266667,142.0933333,142.7666667,143.9333333,140.2533333,139.0866667,138.4133333,0.902173913,1187381196,188059300.5,1
3/23/2017,141.26,141.5844,140.61,140.92,20346301,AAPL,140.211,0.271079922,-1.78,478.0701754,-4.292237443,1.597373296,46.85715854,-7400173.516,4001102.149,92,0,92,0.9744,141.0381333,141.4662667,142.0125333,142.4406667,140.4918667,140.0637333,139.5174667,0.318144499,1167034895,187987364.7,-1
3/24/2017,141.5,141.74,140.35,140.64,22395563,AAPL,140.361,0.271107102,-1.44,419.2307692,-4.931506849,1.524750997,40.19808151,-13050651.82,3226022.423,88,0,88,1.39,140.91,141.47,142.3,142.86,140.08,139.52,138.69,0.208633094,1144639332,187942866,-1
3/27/2017,139.39,141.22,138.62,140.88,23575094,AAPL,140.529,0.271168948,-1.89,405.1470588,-4.383561644,1.498917276,16.72650633,17409300.18,3870716.867,84,0,84,2.6,140.24,141.86,142.84,144.46,139.26,137.64,136.66,0.869230769,1168214426,187983096.6,1
3/28/2017,140.91,144.04,140.62,143.8,33374805,AAPL,141.01,0.27183598,-3.34,175.625,-0.53285968,1.517199173,100.3573471,28690621.84,4998894.366,80,12,68,3.42,142.82,145.02,146.24,148.44,141.6,139.4,138.18,0.929824561,1201589231,188674851.5,1
3/29/2017,143.68,144.49,143.19,144.12,29189955,AAPL,141.376,0.272281122,-3.43,160.8455882,-0.813365575,1.61495498,131.9969581,12574134.46,5343223.461,96,8,88,1.3,143.9333333,144.6766667,145.2333333,145.9766667,143.3766667,142.6333333,142.0766667,0.715384615,1230779186,188739808.2,1
3/30/2017,144.19,144.5,143.5,143.93,21207252,AAPL,141.7,0.272643991,-3.94,173.0688935,-1.252747253,1.786976853,115.722539,-2969015.28,4965394.427,96,4,92,1,143.9766667,144.4533333,144.9766667,145.4533333,143.4533333,142.9766667,142.4533333,0.43,1209571934,188711849.8,-1
3/31/2017,143.72,144.27,143.01,143.66,19661651,AAPL,142.067,0.273087279,-2.2,184.529148,-1.846153846,1.733948316,93.0570421,624179.3968,4768066.471,96,0,96,1.26,143.6466667,144.2833333,144.9066667,145.5433333,143.0233333,142.3866667,141.7633333,0.515873016,1189910283,188674966.2,-1
4/3/2017,143.71,144.12,143.05,143.7,19985714,AAPL,142.291,0.273255954,-3.86,175.5838641,-1.758241758,1.667162635,82.28914433,4295994.598,4746608.659,92,0,92,1.07,143.6233333,144.1966667,144.6933333,145.2666667,143.1266667,142.5533333,142.0566667,0.607476636,1209895997,188680531,1
4/4/2017,143.25,144.89,143.17,144.77,19891354,AAPL,142.784,0.273939216,-3.35,182.5986079,-0.261494879,1.75424245,91.2776359,17115816.23,5308845.367,88,0,88,1.72,144.2766667,145.3833333,145.9966667,147.1033333,143.6633333,142.5566667,141.9433333,0.930232558,1229787351,188828643.3,1
4/5/2017,144.22,145.46,143.81,144.02,27717854,AAPL,143.044,0.274174655,-3.1,229.4294294,-3.099440379,1.63958181,85.60180613,-20662400.25,4128334.202,96,24,72,1.65,144.43,145.05,146.08,146.7,143.4,142.78,141.75,0.127272727,1202069497,188685047.3,-1
4/6/2017,144.29,144.52,143.45,143.66,21149034,AAPL,143.318,0.274435173,-3.02,208.1743869,-3.874300474,1.929375548,60.86540433,-12847544.02,3356703.374,96,20,76,1.07,143.8766667,144.3033333,144.9466667,145.3733333,143.2333333,142.8066667,142.1633333,0.196261682,1180920463,188632182.1,-1
4/7/2017,143.73,144.18,143.27,143.34,16658543,AAPL,143.588,0.274686496,-2.46,328.1914894,-4.563065002,1.966031275,46.29431624,-14095690.23,2563412.756,92,16,76,0.91,143.5966667,143.9233333,144.5066667,144.8333333,143.0133333,142.6866667,142.1033333,0.076923077,1164261920,188595075.5,-1
4/10/2017,143.6,143.8792,142.9,143.17,18933397,AAPL,143.817,0.274858594,0.63,185.2852853,-4.928971158,2.134283108,33.47734913,-8492185.419,2060885.566,88,12,76,0.9792,143.3164,143.7328,144.2956,144.712,142.7536,142.3372,141.7744,0.275735294,1145328523,188572620.7,-1
4/11/2017,142.94,143.35,140.06,141.63,30379376,AAPL,143.6,0.274180046,2.49,2185.714286,-8.243650452,2.297560572,-16.72574129,-1385077.933,1904250.861,84,8,76,3.29,141.68,143.3,144.97,146.59,140.01,138.39,136.72,0.477203647,1114949147,188245846.6,-1
4/12/2017,141.6,142.15,141.01,141.8,20350000,AAPL,143.368,0.273475039,2.13,540.9090909,-7.877744296,2.464076271,-20.56726173,7854385.965,2174711.548,80,4,76,1.14,141.6533333,142.2966667,142.7933333,143.4366667,141.1566667,140.5133333,140.0166667,0.692982456,1135299147,188270272.9,1
4/13/2017,141.91,142.38,141.05,141.05,17822880,AAPL,143.08,0.272664275,2.61,1160.97561,-9.49203616,2.181972635,-27.55894724,-17822880,1265730.114,76,0,76,1.33,141.4933333,141.9366667,142.8233333,143.2666667,140.6066667,140.1633333,139.2766667,0,1117476267,188176005.2,-1
4/17/2017,141.48,141.88,140.87,141.83,16582094,AAPL,142.897,0.272055856,1.87,557.8947368,-7.813172622,1.834425016,-28.89738808,14940302.51,1887301.587,72,44,28,1.01,141.5266667,142.1833333,142.5366667,143.1933333,141.1733333,140.5166667,140.1633333,0.95049505,1134058361,188267703.5,1
4/18/2017,141.41,142.04,141.11,141.2,14697544,AAPL,142.647,0.271321014,3.57,-91.53846154,-9.169177787,1.50345153,-31.51371858,-11852858.06,1262748.875,68,40,28,0.93,141.45,141.79,142.38,142.72,140.86,140.52,139.93,0.096774194,1119360817,188202417.9,-1
4/19/2017,141.88,142,140.45,140.68,17328375,AAPL,142.238,0.270286517,3.34,-59.88372093,-10.28842015,1.177738526,-47.45493772,-12185760.48,651452.9953,64,36,28,1.55,141.0433333,141.6366667,142.5933333,143.1866667,140.0866667,139.4933333,138.5366667,0.148387097,1102032442,188138602.3,-1
4/20/2017,141.22,142.92,141.16,142.44,23319562,AAPL,142.08,0.269731923,1.22,-256.3758389,-6.500215239,0.854684969,-13.06304776,10599800.91,1103650.628,60,32,28,2.24,142.1733333,143.1866667,143.9333333,144.9466667,141.4266667,140.4133333,139.6666667,0.727272727,1125352004,188430345.5,1
4/21/2017,142.44,142.68,141.85,142.27,17320928,AAPL,141.941,0.269214204,1.07,-274.8201439,-6.866121395,0.446279942,-13.55681263,208685.8795,1062970.412,56,28,28,0.83,142.2666667,142.6833333,143.0966667,143.5133333,141.8533333,141.4366667,141.0233333,0.506024096,1108031076,188409673.2,-1
4/24/2017,143.5,143.95,143.18,143.64,17134333,AAPL,141.971,0.269018739,-0.47,-8583.333333,-3.917348257,0.161898599,39.92256413,3337857.078,1166374.351,52,24,28,1.68,143.59,144,144.36,144.77,143.23,142.82,142.46,0.597402597,1125165409,188574669.6,1
4/25/2017,143.91,144.9,143.87,144.53,18871501,AAPL,142.107,0.269024802,-2.9,-2070.833333,-2.001721911,-0.112549315,76.42018282,5313335.233,1354872.573,48,20,28,1.26,144.4333333,144.9966667,145.4633333,146.0266667,143.9666667,143.4033333,142.9366667,0.640776699,1144036910,188691598.3,1
4/26/2017,144.47,144.6,143.3762,143.68,20041241,AAPL,142.312,0.269158903,-1.88,-1461.764706,-3.83125269,-0.286068083,50.13821768,-10091038.33,834603.8959,44,16,28,1.2238,143.8854,144.3946,145.1092,145.6184,143.1708,142.6616,141.947,0.248243177,1123995669,188573733.1,-1
4/27/2017,143.9225,144.16,143.31,143.79,14246347,AAPL,142.511,0.269281301,-2.74,3907.692308,-2.418300654,-0.546450281,49.56899548,1843644.906,880469.3964,40,12,28,0.85,143.7533333,144.1966667,144.6033333,145.0466667,143.3466667,142.9033333,142.4966667,0.564705882,1138242016,188584640,1
4/28/2017,144.09,144.3,143.27,143.65,20860358,AAPL,142.771,0.269517415,-1.82,1638.709677,-2.723311547,-0.504215417,54.81637283,-5468249.184,591891.2791,36,8,28,1.03,143.74,144.21,144.77,145.24,143.18,142.71,142.15,0.368932039,1117381658,188564329.5,-1
5/1/2017,145.1,147.2,144.96,146.58,33602943,AAPL,143.246,0.27016121,-5.38,234.8973607,-1.286307054,-0.432779108,241.3405708,15001313.84,1246865.032,32,4,28,3.55,146.2466667,147.5333333,148.4866667,149.7733333,145.2933333,144.0066667,143.0533333,0.723214286,1150984601,189249721.9,1
5/2/2017,147.54,148.09,146.84,147.51,45352194,AAPL,143.877,0.271097003,-6.83,152.0408163,-1.181503361,-0.229798058,276.6181391,3265357.968,1338614.711,96,0,96,1.51,147.48,148.12,148.73,149.37,146.87,146.23,145.62,0.536,1196336795,189537466.1,1
5/3/2017,145.59,147.49,144.27,147.06,45697034,AAPL,144.515,0.272042223,-4.62,166.730038,-2.098187003,-0.10230064,151.5459452,33492236.1,2800142.956,96,40,56,3.24,146.2733333,148.2766667,149.4933333,151.4966667,145.0566667,143.0533333,141.8366667,0.866459627,1150639761,189398060.9,-1
5/4/2017,146.52,147.14,145.81,146.53,23371872,AAPL,144.924,0.272555166,-4.26,160.0364964,-3.177836627,0.310872635,140.3288209,1933011.97,2760727.911,92,36,56,1.33,146.4933333,147.1766667,147.8233333,148.5066667,145.8466667,145.1633333,144.5166667,0.541353383,1127267889,189313829.3,-1
5/5/2017,146.76,148.98,146.76,148.96,27327725,AAPL,145.593,0.273556692,-5.32,146.1430575,-0.040016006,0.923335598,191.3913924,26835333.56,3855028.168,88,32,56,2.45,148.2333333,149.7066667,150.4533333,151.9266667,147.4866667,146.0133333,145.2666667,0.990990991,1154595614,189767022.3,1
5/8/2017,149.03,153.7,149.03,153.01,48752413,AAPL,146.53,0.275062761,-8.48,122.5232854,-1.26142596,1.438912221,283.3562755,34345918.37,5240977.722,96,28,68,4.74,151.9133333,154.7966667,156.5833333,159.4666667,150.1266667,147.2433333,145.4566667,0.852248394,1203348027,191092527.6,1
5/9/2017,153.87,154.88,153.45,153.99,39130363,AAPL,147.476,0.276582865,-10.31,116.0781367,-1.59269864,2.046368948,271.7824773,-9577361.573,4567416.845,96,24,72,1.87,154.1066667,154.7633333,155.5366667,156.1933333,153.3333333,152.6766667,151.9033333,0.377622378,1242478390,191343150.2,1
5/10/2017,153.63,153.94,152.11,153.26,25805692,AAPL,148.434,0.278119536,-9.47,126.5249538,-2.899069435,2.511686897,181.5668363,6627691.388,4661065.688,96,20,76,1.88,153.1033333,154.0966667,154.9333333,155.9266667,152.2666667,151.2733333,150.4366667,0.628415301,1216672698,191220816.5,-1
5/11/2017,152.45,154.07,152.31,153.95,27255058,AAPL,149.45,0.279760866,-10.3,123.1164384,-1.664280601,2.991314099,148.285002,23538459.18,5519129.028,92,16,76,1.76,153.4433333,154.5766667,155.2033333,156.3366667,152.8166667,151.6833333,151.0566667,0.931818182,1243927756,191343523,1
5/12/2017,154.7,156.42,154.67,156.1,32527017,AAPL,150.695,0.281827153,-9.52,121.6693419,-0.557297109,3.656460966,155.3556285,20631422.21,6206051.446,88,12,76,2.47,155.73,156.79,157.48,158.54,155.04,153.98,153.29,0.817142857,1276454773,191797781.4,1
5/15/2017,156.01,156.65,155.05,155.7,26009719,AAPL,151.607,0.283267754,-8.19,127.7529096,-1.647875108,4.351546234,125.5295276,-4876822.313,5702284.457,96,8,88,1.6,155.8,156.55,157.4,158.15,154.95,154.2,153.35,0.40625,1250445054,191731132.6,-1
5/16/2017,155.94,156.06,154.72,155.47,20048478,AAPL,152.403,0.284488263,-8.41,121.0347752,-2.046834345,5.123542727,98.68146067,2393848.119,5551900.987,96,4,92,1.34,155.4166667,156.1133333,156.7566667,157.4533333,154.7733333,154.0766667,153.4333333,0.559701493,1230396576,191701517,-1
5/17/2017,153.6,154.57,149.71,150.25,50767678,AAPL,152.722,0.284811064,-3.72,219.1950464,-11.10147441,5.421904816,36.67049026,-39485971.78,3504724.952,92,0,92,5.76,151.51,153.31,156.37,158.17,148.45,146.65,143.59,0.111111111,1179628898,189996961.2,-1
5/18/2017,151.27,153.34,151.13,152.54,33568215,AAPL,153.323,0.285659402,-3.58,185.0393701,-7.129228101,5.590669097,39.37017642,9265434.91,3766575.405,88,16,72,3.09,152.3366667,153.5433333,154.5466667,155.7533333,151.3333333,150.1266667,149.1233333,0.63800905,1213197113,190508583.3,1
5/19/2017,153.38,153.98,152.63,153.06,26960788,AAPL,153.733,0.286152331,-0.05,216.6666667,-6.227233304,5.886094374,41.98817573,-9785767.496,3150559.818,84,12,72,1.44,153.2233333,153.8166667,154.5733333,155.1666667,152.4666667,151.8733333,151.1166667,0.318518519,1240157901,190600491,1
5/22/2017,154,154.58,152.91,153.99,22966437,AAPL,153.831,0.286068013,0,216.6666667,-4.614050304,6.285160704,42.74640015,6738655.168,3313655.062,80,8,72,1.67,153.8266667,154.7433333,155.4966667,156.4133333,153.0733333,152.1566667,151.4033333,0.646706587,1263124338,190740036.2,1
5/23/2017,154.9,154.9,153.31,153.8,19918871,AAPL,153.812,0.285767092,-0.54,208.3086053,-4.943625325,6.445822527,39.52648754,-7641831.013,2815678.422,76,4,72,1.59,154.0033333,154.6966667,155.5933333,156.2866667,153.1066667,152.4133333,151.5166667,0.308176101,1243205467,190715459.4,-1
5/24/2017,153.84,154.17,152.67,153.34,19219154,AAPL,153.82,0.285515829,0.61,206.1674009,-5.741543799,6.015473683,26.9920544,-2050043.093,2594509.262,72,0,72,1.5,153.3933333,154.1166667,154.8933333,155.6166667,152.6166667,151.8933333,151.1166667,0.446666667,1223986313,190657976.9,-1
5/25/2017,153.73,154.35,153.03,153.87,19235598,AAPL,153.812,0.285236412,2.23,247.2505092,-4.822202949,5.412992182,25.56280369,5246072.182,2715034.849,68,0,68,1.32,153.75,154.47,155.07,155.79,153.15,152.43,151.83,0.636363636,1243221911,190724462.3,1
5/26/2017,154,154.24,153.31,153.61,21927637,AAPL,153.563,0.284512845,2.09,1348.333333,-5.273200347,4.994151551,20.1049472,-7780774.419,2237952.61,64,0,64,0.93,153.72,154.13,154.65,155.06,153.2,152.79,152.27,0.322580645,1221294274,190687410.3,-1
5/30/2017,153.42,154.43,153.33,153.67,20126851,AAPL,153.36,0.283875856,1.8,-2240.625,-5.169124024,4.454323174,18.11122021,-7684797.655,1786918.507,60,0,60,1.1,153.81,154.29,154.91,155.39,153.19,152.71,152.09,0.309090909,1241421125,190695271.8,1
5/31/2017,153.97,154.17,152.38,152.76,24451164,AAPL,153.089,0.283113718,-2.51,-1434,-6.747614918,3.646671369,6.297856411,-14069664.2,1066164.747,56,12,44,1.79,153.1033333,153.8266667,154.8933333,155.6166667,152.0366667,151.3133333,150.2466667,0.212290503,1216969961,190550477.4,-1
6/1/2017,153.17,153.33,152.22,153.18,16404088,AAPL,153.382,0.283390921,-0.64,-896.1038961,-6.019080659,2.910563604,-1.300763153,11970550.7,1561818.655,52,8,44,1.11,152.91,153.6,154.02,154.71,152.49,151.8,151.38,0.864864865,1233374049,190595579,1
6/2/2017,153.58,155.45,152.89,155.45,27770715,AAPL,153.673,0.283667315,-2.39,-1080,-2.081526453,2.164835056,22.03757821,27770715,2753132.125,48,4,44,2.56,154.5966667,156.3033333,157.1566667,158.8633333,153.7433333,152.0366667,151.1833333,1,1261144764,191007117.8,1
6/5/2017,154.34,154.45,153.46,153.93,25331662,AAPL,153.76,0.283565807,0.06,-396.6101695,-4.718126626,2.092973078,5.762019268,-1279376.869,2569836.261,44,0,44,1.99,153.9466667,154.4333333,154.9366667,155.4233333,153.4433333,152.9566667,152.4533333,0.474747475,1235813102,190759423.2,-1
6/6/2017,153.9,155.81,153.78,154.45,26624926,AAPL,153.806,0.283390063,-0.65,-739.2156863,-2.821591307,1.718739666,23.2076332,-9049851.695,2041668.627,40,8,32,2.03,154.68,155.58,156.71,157.61,153.55,152.65,151.52,0.330049261,1262438028,190849366.5,1
6/7/2017,155.02,155.98,154.48,155.37,21069647,AAPL,153.963,0.283419418,-2.03,165.234375,-1.070551071,1.473383335,46.64666967,3933000.773,2127638.27,36,4,32,1.53,155.2766667,156.0733333,156.7766667,157.5733333,154.5733333,153.7766667,153.0733333,0.593333333,1283507675,190974870.4,1
6/8/2017,155.25,155.54,154.4,154.99,21250798,AAPL,154.128,0.283462446,-1.12,251.8367347,-1.737451737,1.142892644,35.58581914,745642.0351,2064820.259,32,0,32,1.14,154.9766667,155.5533333,156.1166667,156.6933333,154.4133333,153.8366667,153.2733333,0.51754386,1262256877,190922895.7,-1
6/9/2017,155.19,155.19,146.02,148.98,64882657,AAPL,153.639,0.28229936,4.63,-138.4803922,-12.28501229,0.64442059,-145.5320532,-22995489.12,925715.2875,28,0,28,9.17,150.0633333,154.1066667,159.2333333,163.2766667,144.9366667,140.8933333,135.7666667,0.322791712,1197374220,188406960.7,-1
6/12/2017,145.74,146.09,142.51,145.42,72307330,AAPL,152.82,0.280530504,8.25,-55.07584597,-18.53281853,0.053969763,-333.0103571,45242575.2,2940118.011,24,96,-72,6.47,144.6733333,146.8366667,148.2533333,150.4166667,143.2566667,141.0933333,139.6766667,0.812849162,1125066890,186679117.4,-1
6/13/2017,147.16,147.45,145.15,146.59,34165445,AAPL,152.112,0.278970804,6.17,-81.69209431,-16.47946648,-0.471970839,-206.6122342,8615633.957,3198096.008,20,96,-76,2.3,146.3966667,147.6433333,148.6966667,149.9433333,145.3433333,144.0966667,143.0433333,0.626086957,1159232335,186954001,1
6/14/2017,147.5,147.5,143.84,145.16,31531232,AAPL,151.352,0.277317953,8.02,-72.00488998,-18.98911899,-0.785331548,-199.4795358,-8787392.525,2653301.075,16,92,-76,3.66,145.5,147.16,149.16,150.82,143.5,141.84,139.84,0.360655738,1127701103,186646410.7,-1
6/15/2017,143.32,144.4798,142.21,144.29,32165373,AAPL,150.463,0.275432982,11.16,-55.94989562,-20.51597052,-1.10641692,-212.6174725,26786055.18,3750244.443,12,88,-76,2.95,143.6599333,145.1098667,145.9297333,147.3796667,142.8400667,141.3901333,140.5702667,0.916380298,1095535730,186453631.2,-1
6/16/2017,143.78,144.5,142.2,142.27,50361093,AAPL,149.145,0.27276887,11.66,-47.26631393,-24.06107406,-1.439365454,-186.9034037,-47295635.17,1429977.188,8,96,-88,2.3,142.99,143.78,145.29,146.08,141.48,140.69,139.18,0.030434783,1045174637,185748596.8,-1
6/19/2017,143.66,146.74,143.66,146.34,32541404,AAPL,148.386,0.271134986,8.11,-127.8308322,-16.91821692,-1.729474073,-104.4017829,24089091.27,2459936.919,4,96,-92,4.47,145.58,147.5,148.66,150.58,144.42,142.5,141.34,0.87012987,1077716041,186679527.5,1
6/20/2017,146.87,146.87,144.94,145.01,24900073,AAPL,147.442,0.269167074,10.36,-120.9032258,-19.25236925,-2.283102975,-88.71457598,-23093850.09,1298401.146,0,92,-92,1.93,145.6066667,146.2733333,147.5366667,148.2033333,144.3433333,143.6766667,142.4133333,0.03626943,1052815968,186453225.1,-1
6/21/2017,145.52,146.0693,144.61,145.87,21265751,AAPL,146.492,0.267194861,9.12,-134.1997264,-17.74306774,-2.696066393,-76.21191182,15457124.71,1941979.49,0,88,-88,1.4593,145.5164333,146.4228667,146.9757333,147.8821667,144.9635667,144.0571333,143.5042667,0.863427671,1074081719,186579344.3,1
6/22/2017,145.77,146.7,145.1199,145.63,19106294,AAPL,145.556,0.265252795,3.35,-76.78207739,-18.16426816,-3.263466089,-60.33859085,-6770213.284,1545970.728,56,84,-28,1.5801,145.8166333,146.5133667,147.3967333,148.0934667,144.9332667,144.2365333,143.3531667,0.322827669,1054975425,186547908.7,-1
6/23/2017,145.13,147.16,145.11,146.28,35439389,AAPL,145.286,0.264523395,-0.86,-107.0588235,-17.02351702,-4.349624961,-47.00396778,5013376.98,1703580.103,52,80,-28,2.05,146.1833333,147.2566667,148.2333333,149.3066667,145.2066667,144.1333333,143.1566667,0.570731707,1090414814,186706087.7,1
6/26/2017,147.17,148.28,145.38,145.82,25692361,AAPL,145.326,0.264356081,0.77,-88.8760139,-17.83081783,-5.354366575,-35.69308812,-17896058.35,812687.4456,48,76,-28,2.9,146.4933333,147.6066667,149.3933333,150.5066667,144.7066667,143.5933333,141.8066667,0.151724138,1064722453,186625294.1,-1
6/27/2017,145.01,146.16,143.62,143.73,24761891,AAPL,145.04,0.263596043,1.43,-57.98969072,-21.4987715,-5.625452514,-55.24581008,-22617160.28,-252305.633,44,72,-28,2.54,144.5033333,145.3866667,147.0433333,147.9266667,142.8466667,141.9633333,140.3066667,0.043307087,1039960562,186270388.4,-1
6/28/2017,144.49,146.11,143.1601,145.83,22082432,AAPL,145.107,0.263479076,-1.54,-96.61572052,-17.17368235,-5.314827724,-41.12052369,17890370.6,572361.4686,40,68,-28,2.9499,145.0333667,146.9066333,147.9832667,149.8565333,143.9567333,142.0834667,141.0068333,0.905081528,1062042994,186593028.8,1
6/29/2017,144.71,145.13,142.28,143.68,31499368,AAPL,145.046,0.263127623,-1.41,-166.9811321,-20.4840719,-5.226726543,-50.88869452,-552620.4912,521225.925,36,64,-28,3.55,143.6966667,145.1133333,146.5466667,147.9633333,142.2633333,140.8466667,139.4133333,0.49122807,1030543626,186128627.5,-1
6/30/2017,144.45,144.96,143.78,144.02,23024107,AAPL,145.221,0.263203075,2.32,-656.4285714,-8.644480519,-4.965100091,-37.27710353,-13658368.56,-123301.097,32,60,-28,1.28,144.2533333,144.7266667,145.4333333,145.9066667,143.5466667,143.0733333,142.3666667,0.203389831,1053567733,186183111,1
7/3/2017,144.88,145.3001,143.1,143.5,14277848,AAPL,144.937,0.262450236,1.51,-259.5469256,-9.699675325,-4.55221554,-37.42319003,-9086139.259,-530702.8317,28,56,-28,2.2001,143.9667,144.8334,146.1668,147.0335,142.6333,141.7666,140.4332,0.181809918,1039289885,186131559.3,-1
7/5/2017,143.69,144.79,142.7237,144.09,21569557,AAPL,144.845,0.262045823,1.78,-804.6728972,-8.502435065,-3.833267389,-33.19793785,6955328.766,-190428.6682,24,52,-28,2.0663,143.8679,145.0121,145.9342,147.0784,142.9458,141.8016,140.8795,0.661230218,1060859442,186220242.5,1
1/3/2018,172.53,174.55,171.96,172.23,29517899,AAPL,172.488,0.280126229,2.31,1692.45283,-6.355498721,1.597465779,31.53275542,-23363588.01,1399815.787,60,28,32,2.59,172.9133333,173.8666667,175.5033333,176.4566667,171.2766667,170.3233333,168.6866667,0.104247104,1156463090,190019175.9,-1
1/4/2018,172.54,173.47,172.08,173.03,22434597,AAPL,172.337,0.279655717,1.32,1210.526316,-5.332480818,1.616177792,24.00690971,8231398.899,1710342.292,56,24,32,1.39,172.86,173.64,174.25,175.03,172.25,171.47,170.86,0.683453237,1178897687,190123383.5,1
1/5/2018,173.44,175.37,173.05,175,23660018,AAPL,172.402,0.279537421,0.01,401.7985612,-2.813299233,1.265752578,72.33450927,16113288.12,2365021.648,52,20,32,2.34,174.4733333,175.8966667,176.7933333,178.2166667,173.5766667,172.1533333,171.2566667,0.840517241,1202557705,190392760.2,1
1/8/2018,174.35,175.61,173.93,174.35,20567766,AAPL,172.336,0.279207084,0.66,2478.947368,-3.644501279,0.907323861,66.02423011,-10283883,1790071.437,48,16,32,1.68,174.63,175.33,176.31,177.01,173.65,172.95,171.97,0.25,1181989939,190316365.6,-1
1/9/2018,174.55,175.06,173.41,174.33,21583997,AAPL,172.268,0.278874114,-3.76,-333.492823,-3.670076726,0.701915654,45.65869674,2485429.958,1821678.643,44,12,32,1.65,174.2666667,175.1233333,175.9166667,176.7733333,173.4733333,172.6166667,171.8233333,0.557575758,1160405942,190313889.7,-1
1/10/2018,173.16,174.3,173,174.29,23959895,AAPL,172.64,0.279250243,-3.69,-2788,-2.246169826,0.333953262,30.86588239,23591281.23,2811206.033,40,8,32,1.33,173.8633333,174.7266667,175.1633333,176.0266667,173.4266667,172.5633333,172.1266667,0.992307692,1136446047,190308392.1,-1
1/11/2018,174.59,175.4886,174.49,175.28,18667729,AAPL,173.108,0.279781036,-4.2,855.9139785,-0.960789405,-0.116428205,78.54248102,10868633.73,3177452.746,36,4,32,1.1986,175.0862,175.6824,176.0848,176.681,174.6838,174.0876,173.6852,0.791107551,1155113776,190414428.3,1
1/12/2018,176.18,177.36,175.65,177.09,25418080,AAPL,173.709,0.280526548,-7.86,437.9807692,-0.344563553,0.074929241,140.5883226,17391317.89,3823537.526,32,0,32,2.08,176.7,177.75,178.41,179.46,176.04,174.99,174.33,0.842105263,1180531856,190676903.9,1
1/16/2018,177.9,179.39,176.14,176.19,29565947,AAPL,174.405,0.28142151,-3.93,772.0338983,-3.980594601,0.232069998,150.4691551,-28656225.55,2347184.659,96,8,88,3.25,177.24,178.34,180.49,181.59,175.09,173.99,171.84,0.015384615,1150965909,190526645,-1
1/17/2018,176.15,179.25,175.07,179.1,34386836,AAPL,175.089,0.282298649,-6.87,140.9144197,-0.360741386,0.446666354,159.8732387,31918881.26,3691352.686,96,4,92,4.18,177.8066667,180.5433333,181.9866667,184.7233333,176.3633333,173.6266667,172.1833333,0.964114833,1185352745,191094586.9,1
1/18/2018,179.37,180.1,178.25,179.26,31193352,AAPL,175.792,0.283204167,-6.23,140.3002309,-1.035758323,0.973796544,190.2707983,2866416.13,3653855.57,92,0,92,1.85,179.2033333,180.1566667,181.0533333,182.0066667,178.3066667,177.3533333,176.4566667,0.545945946,1216546097,191122453.7,1
1/19/2018,178.61,179.58,177.41,178.46,32425067,AAPL,176.335,0.283849868,-3.46,158.1300813,-2.022194821,1.325035498,136.8702009,-1045969.903,3440227.139,96,48,48,2.17,178.4833333,179.5566667,180.6533333,181.7266667,177.3866667,176.3133333,175.2166667,0.483870968,1184121030,190977747.4,-1
1/22/2018,177.3,177.78,176.6016,177,27108551,AAPL,176.535,0.283942704,-2.65,150.1930502,-3.82244143,1.624137072,79.13980232,-8778532.809,2884828.96,92,44,48,1.8584,177.1272,177.6528,178.3056,178.8312,176.4744,175.9488,175.296,0.33808554,1157012479,190755969.5,-1
